GGGGGGGGGGGGGGGGGGGGGGGGGGGGGGGGGGGGGGGGGGGGGGGGGGG-------------------
G------------------------------------------------G--------------------
G------------------------------------------------G--------------------
GM-----------------------------------------------G--------------------
GM-GGGGG-----------------------------------------G--------------------
GM-GGGGGiNN--i-------iNN--i----------MGGGGGG-----G--------------------
GM-MGGGG-------iNN--i----------------MGK---G-----G--------------------
G--MGGGG-----------------------------MG----G-----G--------------------
G--MG-MG-----------------------------MG----------G--------------------
G--MGKMG------------------------------G----------G--------------------
GM--G-MG------------------------------G--------D-G--------------------
GM----MG---------------------iNN-----iGGGGGGGGGGGG--------------------
G-----lGLLLLLLLLLLLLLLLLLLLLLLLLLLLLLLG----------G--------------------
G--MG--GGGGGGGGGGGGGGGGGGGGGGGGGGGGGGGG----------G--------------------
G--MG--------------------------------------------G--------------------
GM-MG--------------------------------------------G--------------------
GM-----------------------------------------------G--------------------
GM-----------------------------------------------G--------------------
G------------------------------------------------G--------------------
GGGGGGGGGGG--------------------------------------G--------------------
G---------G--------------------------------------G--------------------
G---------G^NN-^G^-----G-------------------------G--------------------
G--------------^G^NN--^G^NN---i------------------G--------------------
G------------------------------------------------G--------------------
G-S--------------------------GG------------------G--------------------
G----------------------------GG^NN--^GG^NN---i--KG--------------------
GGGGGGGGGGGGGGGGGGGGGGGGGGGGGGGLLLLLLGGLLLLLLGGGGG--------------------
GGGGGGGGGGGGGGGGGGGGGGGGGGGGGGGGGGGGGGGGGGGGGGGGGGG-------------------
GGGGGGGGGGGGGGGGGGGGGGGGGGGGGGGGGGGGGGGGGGGGGGGGGGG-------------------
----------------------------------------------------------------------
----------------------------------------------------------------------
----------------------------------------------------------------------
----------------------------------------------------------------------
----------------------------------------------------------------------
----------------------------------------------------------------------
----------------------------------------------------------------------
----------------------------------------------------------------------
----------------------------------------------------------------------
----------------------------------------------------------------------
----------------------------------------------------------------------
----------------------------------------------------------------------
----------------------------------------------------------------------
----------------------------------------------------------------------
----------------------------------------------------------------------
----------------------------------------------------------------------
----------------------------------------------------------------------
----------------------------------------------------------------------
----------------------------------------------------------------------
----------------------------------------------------------------------
----------------------------------------------------------------------
----------------------------------------------------------------------
----------------------------------------------------------------------
----------------------------------------------------------------------
----------------------------------------------------------------------
----------------------------------------------------------------------
----------------------------------------------------------------------
----------------------------------------------------------------------
----------------------------------------------------------------------
----------------------------------------------------------------------
----------------------------------------------------------------------
----------------------------------------------------------------------
----------------------------------------------------------------------
----------------------------------------------------------------------
----------------------------------------------------------------------
----------------------------------------------------------------------
----------------------------------------------------------------------
----------------------------------------------------------------------
----------------------------------------------------------------------
----------------------------------------------------------------------
----------------------------------------------------------------------
