GGGGGGGGGGGGGGGGGGGGGGGGGGGGGGGGGGGGGGGGGGGGGGGGGGG
G-------------------------e----------------------G
Gl-----------------------------------------------G
G------------------------------------------------G
G------------------------------------------------G
G------------------------------------------------G
G------------------------------------------------G
G-----------------MG-----------------GGGG--------G
G------GM---------lG-----------------------------G
G------GM----------G-----------------------------G
G------Gl----------Gl----------------------------G
G------GM----------G-----------------------------G
Gl-----GM----------GM----------------------------G
G------GM----------------------------------------G
G------GM----------------------------------------G
G------GM----------------------------------------G
G------GM--------------^-------------------------G
G------GM-------------MGM------------------------G
G------G--------------MGM------------------------G
G------l--------------MGM----G-------------------G
G---------------------MGM---gGM------------------G
G---------------------MGl---^GM------------------G
G---------------------MGM---MGM------------------G
G---------------------------MGM------------------G
G---------------------------MGM------------------G
G----S---^---K----BBBB---------MGM----l--------D-G
GGGGGGGGGGGGGGGGGGGGGGGGGGGGGG------GGGGGGGGGGGG
GGGGGGGGGGGGGGGGGGGGGGGGGGGGGGGGGGGGGGGGGGGGGGGGGGG
GGGGGGGGGGGGGGGGGGGGGGGGGGGGGGGGGGGGGGGGGGGGGGGGGGG