GGGGGGGGGGGGGGGGGGGGGGGGGGGGGGGGGGGGGGGGGGGGGGGGGGG
G-----------l-l-l---------e---l-l---l--l---l-----G
Gl-----------------------------------------------G
G-----------------------------------------------lG
G------------------------------------------------G
G-----------------------------------------------lG
G-------------------------------G----------------G
G-----------------MG------------G---lGGGGl-------G
G------GM---------lG------------G----llll--------G
G------GM----------G------------G----------------G
G-----lGl----------Gl-----------G---G---lG-l-----G
G------GM---------lG------------G-----lGlllGl----G
Gl-----Gl----------GM-----------G----------l-----G
G------GM-----------------------G----ll---------lG
G------GM-----------------------G---lGGl--Gl----lG
G------GM-----------------------Gl---ll-l--------G
G------GM--------------^--------G--lG--lGl---G---G
G------GM-------------MGM--------l------l--------G
G------G--------------MGM--------G--Gll----G-l---G
G------l--------------MGM----G---l---lGl---l---G-G
G---------------------MGM---gGM-----G-l---l----l-G
G---------------------MGl---^GM--G--------G--G---G
G---------------------MGM---MGM----G--G---l--l---G
G---------------------------MGM--G-G-----l---l---G
G---------------------------MGM------G--lG--lGl--G
G----S---^--DK----BBBB---------MGM----l----------G
GGGGGGGGGGGGGGGGGGGGGGGGGGGGGG------GGGGGGGGGGGG
GGGGGGGGGGGGGGGGGGGGGGGGGGGGGGGGGGGGGGGGGGGGGGGGGGG
GGGGGGGGGGGGGGGGGGGGGGGGGGGGGGGGGGGGGGGGGGGGGGGGGGG