GGGGGGGGGGGGGGGGGGGGGGGGGGGGGGGGGGGGGGGGGGGGGGGGGGG
G^^^^^^^^^^^^^^^^^^^^^^^^^^^^^^^^^^^^^^^^^^^^^^^^^G
G^--------------------------------------------^-G
G^---------------------------------------------^G
G^--S-----------------------------------------^G
G^-MGM----------------------------------------^G
G^-MGM----------------------------------------^G
G^-MGM----MGM---------------------------------^G
G^-MGM----MGM---------------------------------^G oO
G^-MGM----MGM---------------------------------^G
G^-MGM----MGM---------------------------------^G
G^-MGM----MGM---------------------------------^G
G^-MGM----MGM---------------------------------^G
G^-MGM----MGM---------------------------------^G
G^-MGM----MGM---------------------------------^G
G^-MGM----MGM---------------------------------^G
G^-MGM----MGM---------------------------------^G
G^-MGM----MGM---------------------------------^G
G^-MGM----MGM---------------------------------^G
G^-MGM----MGM---------------------------------^G
G^-MGM----MGM---------------------------------^G
G^-MGM----MGM---------------------------------^G
G^--------MGM---------------------------------^G
G^--------MGM---------------------------------^G
G^--------------------------------------------^G
G^--------------------------------------------^G
G^^^^^^^^^^^^^^^^^^^^^^^^^^^^^^^^^^^^^^^^^^^^^^^^^^G
GGGGGGGGGGGGGGGGGGGGGGGGGGGGGGGGGGGGGGGGGGGGGGGGGGG
GGGGGGGGGGGGGGGGGGGGGGGGGGGGGGGGGGGGGGGGGGGGGGGGGGG