GGGGGGGGGGGGGGGGGGGGGGGGGGGGGGGGGGGGGGGGGGGGGGGGGG
G------------------------------------------------G
G------------------------------------------------G
G------------------------------------------------G
G------------------------------------------------G
G------------------------------------------------G
G------------------------------------------------G
G------------------------------------------------G
G------------------------------------------------G
G-----------------------------------------------lG
G------------------------------------------------G
GGGGGGGGGGGGGGGGGGGGGGGGGGGGG--------------------G
G---------------------------G--------------------G
G---------------------------G--------------------G
G--------------------------eG--------------------G
G---------------------------G--------------------G
G---------------------------G--------------------G
G----S----------------------G--------------------G
GGGGGG---------G--------G---G--------------------G
GGGGGG---------G--------G^--G--------------------G
GGGGGG---------G--------G^--^---^G---------------G
GGGGGG---------G--------G^------^G---------------G
GGGGGG---------G--------G^------^G---------------G
GGGGGG---------G--------G^^^^^^^^G---------------G
GGGGGG-------GGG--------GGGGGGGGGG---------------G
GGGGGG-------^^G--------G------------------------G
GGGGGG^^^^^----G^^^^^^^^G------------------------G
GGGGGGGGGGGGGGGGGGGGGGGGGGGGGGGGGGGGGGGGGGGGGGGGGG