GGGGGGGGGGGGGGGGGGGGGGGGGGGGGGGGGGGGGGGGGGGGGGGGGGG
GllllllllllllllllllllllllllllllllllllllllllllllllG
Gl----------------------------------------------lG
Gl----------------------------------------------lG
Gl----------------------------------------------lG
Gl----------------------------------------------lG
Gl----------------------------------------------lG
Gl----------------------------------------------lG
Gl----------------------------------------------lG
Gl----------------------------------------------lG
Gl----------------------------------------------lG
Gl----------------------------------------------lG
Gl---------------------GGG----------------------lG
Gl---------------------GSG----------------------lG
Gl---------------------GGG----------------------lG
Gl----------------------------------------------lG
Gl----------------------------------------------lG
Gl----------------------------------------------lG
Gl----------------------------------------------lG
Gl----------------------------------------------lG
Gl----------------------------------------------lG
Gl----------------------------------------------lG
Gl----------------------------------------------lG
Gl----------------------------------------------lG
Gl----------------------------------------------lG
GllllllllllllllllllllllllllllllllllllllllllllllllG
GGGGGGGGGGGGGGGGGGGGGGGGGGGGGGGGGGGGGGGGGGGGGGGGGGG
GGGGGGGGGGGGGGGGGGGGGGGGGGGGGGGGGGGGGGGGGGGGGGGGGGG
GGGGGGGGGGGGGGGGGGGGGGGGGGGGGGGGGGGGGGGGGGGGGGGGGGG