GGGGGGGGGGGGGGGGGGGGGGGGGGGGGGGGGGGGGGGGGGGGGGGGGGG
Glllllllllllllllllllllll-llllllllllllllllllllllllG
Gl----------------------------------------------lG
Gl----------------------------------------------lG
Gl----------------------------------------------lG
Gl----------------------------------------------lG
Gl----------------------------------------------lG
Gl----------------------------------------------lG
Gl----------------------------------------------lG
Gl----------------------------------------------lG
Gl----------------------------------------------lG
Gl----------------------------------------------lG
Gl----------------------------------------------lG
G-----------------------S------------------------G
Gl----------------------G-----------------------lG
Gl----------------------------------------------lG
Gl----------------------------------------------lG
Gl----------------------------------------------lG
Gl----------------------------------------------lG
Gl----------------------------------------------lG
Gl----------------------------------------------lG
Gl----------------------------------------------lG
Gl----------------------------------------------lG
Gl----------------------------------------------lG
Gl----------------------------------------------lG
GllllllllllllllllllllllllllllllllllllllllllllllllG
GGGGGGGGGGGGGGGGGGGGGGGGGGGGGGGGGGGGGGGGGGGGGGGGGGG
GGGGGGGGGGGGGGGGGGGGGGGGGGGGGGGGGGGGGGGGGGGGGGGGGGG
GGGGGGGGGGGGGGGGGGGGGGGGGGGGGGGGGGGGGGGGGGGGGGGGGGG