GGGGGGGGGGGGGGGGGGGGGGGGGGGGGGGGGGGGGGGGGGGGGGGGGGG-------------------
G--------------------e---------------------------G--------------------
G------------------------------------------------G--------------------
GM-^---------------------------------------------G--------------------
GM-GGGGG------------------------------^----------G--------------------
GM-GGGGGiNN--i-------iNN--i----------MGGGGGG-----G--------------------
GM-MGGGG-------iNN--i----------------MGK---G-----G--------------------
G--MGGGG-----------------------------MG----G-----G--------------------
G--MG^^G-----------------------------MG----------G--------------------
G--MGKMG------------------------------G----------G--------------------
GM--G-MG------------------------------G---^^---D-G--------------------
GM----MG---------------------iNN-----iGGGGGGGGGGGG--------------------
G-----lGLLLLLLLLLLLLLLLLLLLLLLLLLLLLLLG----------G--------------------
G--MG--GGGGGGGGGGGGGGGGGGGGGGGGGGGGGGGG----------G--------------------
G--MG--------------c-----------------------------G--------------------
GM-MG--------------------------------------------G--------------------
GM-----------------------------------------------G--------------------
GM-----------------------------------------------G--------------------
G--------^---------------------------------------G--------------------
GGGGGGGGGG^--------------------------------------G--------------------
G--------^---------------------------------------G--------------------
G---------i-NN--i--------------------------------G--------------------
G---------------i-NN--i-iNN--i-------------------G--------------------
G------------------------------------------------G--------------------
G-S--------------------------GG------------------G--------------------
G------^^^^---------------^^^GGiNN---iiNN----i^^KG--------------------
GGGGGGGGGGGGGGGGGGGGGGGGGGGGGGGLLLLLLLLLLLLLLGGGGG--------------------
GGGGGGGGGGGGGGGGGGGGGGGGGGGGGGGGGGGGGGGGGGGGGGGGGGG-------------------
GGGGGGGGGGGGGGGGGGGGGGGGGGGGGGGGGGGGGGGGGGGGGGGGGGG-------------------
----------------------------------------------------------------------
----------------------------------------------------------------------
----------------------------------------------------------------------
----------------------------------------------------------------------
----------------------------------------------------------------------
----------------------------------------------------------------------
----------------------------------------------------------------------
----------------------------------------------------------------------
----------------------------------------------------------------------
----------------------------------------------------------------------
----------------------------------------------------------------------
----------------------------------------------------------------------
----------------------------------------------------------------------
----------------------------------------------------------------------
----------------------------------------------------------------------
----------------------------------------------------------------------
----------------------------------------------------------------------
----------------------------------------------------------------------
----------------------------------------------------------------------
----------------------------------------------------------------------
----------------------------------------------------------------------
----------------------------------------------------------------------
----------------------------------------------------------------------
----------------------------------------------------------------------
----------------------------------------------------------------------
----------------------------------------------------------------------
----------------------------------------------------------------------
----------------------------------------------------------------------
----------------------------------------------------------------------
----------------------------------------------------------------------
----------------------------------------------------------------------
----------------------------------------------------------------------
----------------------------------------------------------------------
----------------------------------------------------------------------
----------------------------------------------------------------------
----------------------------------------------------------------------
----------------------------------------------------------------------
----------------------------------------------------------------------
----------------------------------------------------------------------
----------------------------------------------------------------------
----------------------------------------------------------------------
