GGGGGGGGGGGGGGGGGGGGGGGGGGGGGGGGGGGGGGGGGGGGGGGGGGG-------------------
G----------------ll--e---------------------------G--------------------
G------------------------------------------------G--------------------
GM-^---------------------------------------------G--------------------
GM-GGGGG------------------------------^----------G--------------------
GM-GGGGGiNN--i-------iNN--i----------MGGGGGG-----G--------------------
GM-MGGGG-------iNN--i----------------MGK---G-----G--------------------
G--MGGGG-----------------------------MG----G-----G--------------------
G--MG^^G-----------------------------MG----------G--------------------
G--MGKMG------------------------------G----------G--------------------
GM--G-MG------------------------------G---^^---D-G--------------------
GM----MG---------------------iNN-----iGGGGGGGGGGGG--------------------
G^----lGLLLLLLLLLLLLLLLLLLLLLLLLLLLLLLG-------ll-G--------------------
G^-MG--GGGGGGGGGGGGGGGGGGGGGGGGGGGGGGGG----------G--------------------
G^-MG--------------c---l-------------------------G--------------------
GM-MG-------i------------------------------------G--------------------
GM-----------------------------------------------G--------------------
GM-----------------------------------------------G--------------------
G---------^--------------------------------------G--------------------
GGGGGGGGGGG^-------------------------------------G--------------------
G---------G^-------------------------------------G--------------------
G---------G^NN-^G^----^G^------------------------G--------------------
G--------------^G^NN--^G^NN---i------------------G--------------------
G------------------------------------^^----------G--------------------
G-S--------------------------GG^NN--^GG^NN----^^KG--------------------
G------^^^^---------------^^^GGLLLLLLGGLLLLLLGGGGG--------------------
GGGGGGGGGGGGGGGGGGGGGGGGGGGGGGGGGGGGGGGGGGGGGGGGGG--------------------
GGGGGGGGGGGGGGGGGGGGGGGGGGGGGGGGGGGGGGGGGGGGGGGGGGG-------------------
GGGGGGGGGGGGGGGGGGGGGGGGGGGGGGGGGGGGGGGGGGGGGGGGGGG-------------------
----------------------------------------------------------------------
----------------------------------------------------------------------
----------------------------------------------------------------------
----------------------------------------------------------------------
----------------------------------------------------------------------
----------------------------------------------------------------------
----------------------------------------------------------------------
----------------------------------------------------------------------
----------------------------------------------------------------------
----------------------------------------------------------------------
----------------------------------------------------------------------
----------------------------------------------------------------------
----------------------------------------------------------------------
----------------------------------------------------------------------
----------------------------------------------------------------------
----------------------------------------------------------------------
----------------------------------------------------------------------
----------------------------------------------------------------------
----------------------------------------------------------------------
----------------------------------------------------------------------
----------------------------------------------------------------------
----------------------------------------------------------------------
----------------------------------------------------------------------
----------------------------------------------------------------------
----------------------------------------------------------------------
----------------------------------------------------------------------
----------------------------------------------------------------------
----------------------------------------------------------------------
----------------------------------------------------------------------
----------------------------------------------------------------------
----------------------------------------------------------------------
----------------------------------------------------------------------
----------------------------------------------------------------------
----------------------------------------------------------------------
----------------------------------------------------------------------
----------------------------------------------------------------------
----------------------------------------------------------------------
----------------------------------------------------------------------
----------------------------------------------------------------------
----------------------------------------------------------------------
----------------------------------------------------------------------
