GGGGGGGGGGGGGGGGGGGGGGGGGGGGGGGGGGGGGGGGGGGGGGGGGGG-------------------
G----------------ll--e---------------------------G--------------------
G------------------------------------------------G--------------------
GM-^^--------------------------------------------G--------------------
GM^GGGGG------------------------------^^---------G--------------------
GM^GGGGGiNN--i-------iNN--i----------MGGGGGG-----G--------------------
GM-MGGGG-------iNN--i----------------MGK--cG-----G--------------------
GM-MGGGG------------iB---------------MG----G-----G--------------------
G^-MG^^G-----------------------------MG----------G--------------------
G^-MGKMG------------------------------G----------G--------------------
GM--G-MG------------------------------G---^^---D-G--------------------
GM----MG---------------------iNN-----iGGGGGGGGGGGG--------------------
G^----lGLLLLLLLLLLLLLLLLLLLLLLLLLLLLLLG-------ll-G--------------------
G^-MG--GGGGGGGGGGGGGGGGGGGGGGGGGGGGGGGG----------G--------------------
G^-MG------------------l---c-------G-------------G--------------------
GM-MG------------------------------GK-^----------G--------------------
GM--------i------------------------GGGG----------G--------------------
GM-----------------------------------------------G--------------------
G-B-------^-------------------------i-----N-----^G--------------------
GGGGGGGGGGG^------------------------------------^G--------------------
G---------G^-------------------------i---------N^G--------------------
G---------G^NN-^G^----^G^-----------------------^G--------------------
G--------------^G^NN--^G^NN-----i-----iN--------^G--------------------
G----------------------------^^------^^----------G--------------------
G-S-------------------------^GG^NN--^GG^NN----^-KG--------------------
G------^^^^---------------^^^GGLLLLLLGGLLLLLLGGGGG--------------------
GGGGGGGGGGGGGGGGGGGGGGGGGGGGGGGGGGGGGGGGGGGGGGGGGG--------------------
GGGGGGGGGGGGGGGGGGGGGGGGGGGGGGGGGGGGGGGGGGGGGGGGGGG-------------------
GGGGGGGGGGGGGGGGGGGGGGGGGGGGGGGGGGGGGGGGGGGGGGGGGGG-------------------
----------------------------------------------------------------------
----------------------------------------------------------------------
----------------------------------------------------------------------
----------------------------------------------------------------------
----------------------------------------------------------------------
----------------------------------------------------------------------
----------------------------------------------------------------------
----------------------------------------------------------------------
----------------------------------------------------------------------
----------------------------------------------------------------------
----------------------------------------------------------------------
----------------------------------------------------------------------
----------------------------------------------------------------------
----------------------------------------------------------------------
----------------------------------------------------------------------
----------------------------------------------------------------------
----------------------------------------------------------------------
----------------------------------------------------------------------
----------------------------------------------------------------------
----------------------------------------------------------------------
----------------------------------------------------------------------
----------------------------------------------------------------------
----------------------------------------------------------------------
----------------------------------------------------------------------
----------------------------------------------------------------------
----------------------------------------------------------------------
----------------------------------------------------------------------
----------------------------------------------------------------------
----------------------------------------------------------------------
----------------------------------------------------------------------
----------------------------------------------------------------------
----------------------------------------------------------------------
----------------------------------------------------------------------
----------------------------------------------------------------------
----------------------------------------------------------------------
----------------------------------------------------------------------
----------------------------------------------------------------------
----------------------------------------------------------------------
----------------------------------------------------------------------
----------------------------------------------------------------------
----------------------------------------------------------------------
