GGGGGGGGGGGGGGGGGGGGGGGGGGGGGGGGGGGGGGGGGGGGGGGGGGG-------------------
G----------------ll--e---------------------------G--------------------
G------------------------------------------------G--------------------
GM-^^--------------------------------------------G--------------------
GM-GGGGG------------------------------^^---------G--------------------
GM-GGGGGiNN--i-------iNN--i----------MGGGGGG-----G--------------------
GM-MGGGG-------iNN--i----------------MGK--cG-----G--------------------
GM-MGGGG------------iB---------------MG----G-----G--------------------
G--MG^^G-----------------------------MG----------G--------------------
G--MGKMG------------------------------G----------G--------------------
GM--G-MG------------------------------G---^^---D-G--------------------
GM----MG---------------------iNN-----iGGGGGGGGGGGG--------------------
G^----lGLLLLLLLLLLLLLLLLLLLLLLLLLLLLLLG-------ll-G--------------------
G^-MG--GGGGGGGGGGGGGGGGGGGGGGGGGGGGGGGG----------G--------------------
G^-MG--------------c---l---c-------G-------------G--------------------
GM-MG------------------------------GK------------G--------------------
GM---------------------------------GGGG----------G--------------------
GM--------------------------------i--------------G--------------------
G-B------^--------------------------iN---i-------G--------------------
GGGGGGGGGG^------------------------i------------BG--------------------
G--------^------------------------------iN---i---G--------------------
G---------i-NN--i-------------------iB-----------G--------------------
G---------------i-NN--i-iNN--i-------------iN---iG--------------------
G----------------------------^-------------------G--------------------
G-S--------------------------GG------------------G--------------------
G------^^^^---------------^^^GGiNN---iiNN----i^^KG--------------------
GGGGGGGGGGGGGGGGGGGGGGGGGGGGGGGLLLLLLLLLLLLLLGGGGG--------------------
GGGGGGGGGGGGGGGGGGGGGGGGGGGGGGGGGGGGGGGGGGGGGGGGGGG-------------------
GGGGGGGGGGGGGGGGGGGGGGGGGGGGGGGGGGGGGGGGGGGGGGGGGGG-------------------
----------------------------------------------------------------------
----------------------------------------------------------------------
----------------------------------------------------------------------
----------------------------------------------------------------------
----------------------------------------------------------------------
----------------------------------------------------------------------
----------------------------------------------------------------------
----------------------------------------------------------------------
----------------------------------------------------------------------
----------------------------------------------------------------------
----------------------------------------------------------------------
----------------------------------------------------------------------
----------------------------------------------------------------------
----------------------------------------------------------------------
----------------------------------------------------------------------
----------------------------------------------------------------------
----------------------------------------------------------------------
----------------------------------------------------------------------
----------------------------------------------------------------------
----------------------------------------------------------------------
----------------------------------------------------------------------
----------------------------------------------------------------------
----------------------------------------------------------------------
----------------------------------------------------------------------
----------------------------------------------------------------------
----------------------------------------------------------------------
----------------------------------------------------------------------
----------------------------------------------------------------------
----------------------------------------------------------------------
----------------------------------------------------------------------
----------------------------------------------------------------------
----------------------------------------------------------------------
----------------------------------------------------------------------
----------------------------------------------------------------------
----------------------------------------------------------------------
----------------------------------------------------------------------
----------------------------------------------------------------------
----------------------------------------------------------------------
----------------------------------------------------------------------
----------------------------------------------------------------------
----------------------------------------------------------------------
