GGGGGGGGGGGGGGGGGGGGGGGGGGGGGGGGGGGGGGGGGGGGGGGGGGG-------------------
G-l-----------e--ll--e------G--KGK-MG------------G--------------------
G---------------------------G-GGGGGMG------------G--------------------
GM-^^-----------------------G-------G------------G--------------------
GM^GGGGG--------------------GM--G---G-^^---------G--------------------
GM^GGGGG^NN---i-----i-NN-^G-GMB------MGGGGGG-----G--------------------
GM-MGGGG------i-NN--i-----G-GM-------MGK--cG-----G--------------------
GM-MGGGG------------------G-GM-------MG----G-----G--------------------
G^-MG^^G------------------G-GM------BMG----------G--------------------
G^-MGKMG------------------G-----------G----------G--------------------
GM--G-MG------------------G-----------G^--^^---D-G--------------------
GM----MGe----------------eG^--NN-----iGGGGGGGGGGGG--------------------
G^----lGLLLLLLLLLLLLLLLLLLGLLLLLLLLLLLG-------ll-G--------------------
G^-MG--GGGGGGGGGGGGGGGGGGGGGGGGGGGGGGGG----------G--------------------
G^-MG-----------l--c---l--ec-------G-------------G--------------------
GM-MG------------------------------GK-^----------G--------------------
GM--------i------------------------GGGG----------G--------------------
GM-----------------------------------------------G--------------------
G^----B---^-------------------------i-----N-----^G--------------------
GGGGGGGGGGG^------------------------------------^G--------------------
G---------G^----^------^-------------i---------N^G--------------------
G---------G^NN-^G^----^G^-----------------------^G--------------------
G--------------^G^NN--^G^NN-----i-----iN--------^G--------------------
G---------------^------^-----^^-----------------^G--------------------
G-S-------------------------^GG^-----^^----------G--------------------
G------^^^^-------^^^-----^^^GG^NN--^GG^NN---i^-KG--------------------
GGGGGGGGGGGGGGGGGGGGGGGGGGGGGGGLLLLLLGGLLLLLLGGGGG--------------------
GGGGGGGGGGGGGGGGGGGGGGGGGGGGGGGGGGGGGGGGGGGGGGGGGGG-------------------
GGGGGGGGGGGGGGGGGGGGGGGGGGGGGGGGGGGGGGGGGGGGGGGGGGG-------------------
----------------------------------------------------------------------
----------------------------------------------------------------------
----------------------------------------------------------------------
----------------------------------------------------------------------
----------------------------------------------------------------------
----------------------------------------------------------------------
----------------------------------------------------------------------
----------------------------------------------------------------------
----------------------------------------------------------------------
----------------------------------------------------------------------
----------------------------------------------------------------------
----------------------------------------------------------------------
----------------------------------------------------------------------
----------------------------------------------------------------------
----------------------------------------------------------------------
----------------------------------------------------------------------
----------------------------------------------------------------------
----------------------------------------------------------------------
----------------------------------------------------------------------
----------------------------------------------------------------------
----------------------------------------------------------------------
----------------------------------------------------------------------
----------------------------------------------------------------------
----------------------------------------------------------------------
----------------------------------------------------------------------
----------------------------------------------------------------------
----------------------------------------------------------------------
----------------------------------------------------------------------
----------------------------------------------------------------------
----------------------------------------------------------------------
----------------------------------------------------------------------
----------------------------------------------------------------------
----------------------------------------------------------------------
----------------------------------------------------------------------
----------------------------------------------------------------------
----------------------------------------------------------------------
----------------------------------------------------------------------
----------------------------------------------------------------------
----------------------------------------------------------------------
----------------------------------------------------------------------
----------------------------------------------------------------------
