GGGGGGGGGGGGGGGGGGGGGGGGGGGGGGGGGGGGGGGGGGGGGGGGGGG-------------------
G-l-----------e--ll--e------G--KGK-MG-------c----G--------------------
G---------------------------G-GGGGGMG------------G--------------------
GM-^^-----------------------G-------G------------G--------------------
GM^GGGGG------------------^-GM--G---G-^^---^----cG--------------------
GM^GGGGG^NN---i-----i-NN--G-GMB------MGGG--G^----G--------------------
GM-MGGGG------i-NN--i-----G-GM-------MGK--pG^----G--------------------
GM-MGGGG------------------G-GM-------MG----G-----G--------------------
G^-MG^^G------------------G-GM------BMG----------G--------------------
G^-MGKMG------------------G-G---------G---------cG--------------------
GM--G-MG------------------G-----------G^--^^-----G--------------------
GM----MGe----------------eG--iNN-----iGGGGGGGGGGGG--------------------
G^----lGLLLLLLLLLLLLLLLLLLGLLLLLLLLLLLG-------ll-G--------------------
G^-MG--GGGGGGGGGGGGGGGGGGGGGGGGGGGGGGGG----------G--------------------
G^-MG-----------l--c---l--ec-------G-------------G--------------------
GM-MG------------------------------GK-^----------G--------------------
GM--------i-----B------------------GGGG--B-------G--------------------
GM-----------------------------------ll----------G--------------------
G^----B---^-------------------------i-----N-----^G--------------------
GGGGGGGGGGG^------------------------------------^G--------------------
G---------G^----^------^-------------i---------N^G--------------------
G---------G^NN-^G^--N-^G^-----------------------^G--------------------
G--------------^G^NN--^G^NN-----i-----iN--------^G--------------------
G---------------^------^-----^^------^^----------G--------------------
G-S-------------------------^GG^NN--^GG^NN---^^-DG--------------------
G------^^^^-------^^^-----^^^GGLLLLLLGGLLLLLLGGGGG--------------------
GGGGGGGGGGGGGGGGGGGGGGGGGGGGGGGGGGGGGGGGGGGGGGGGGG--------------------
GGGGGGGGGGGGGGGGGGGGGGGGGGGGGGGGGGGGGGGGGGGGGGGGGGG-------------------
GGGGGGGGGGGGGGGGGGGGGGGGGGGGGGGGGGGGGGGGGGGGGGGGGGG-------------------
----------------------------------------------------------------------
----------------------------------------------------------------------
----------------------------------------------------------------------
----------------------------------------------------------------------
----------------------------------------------------------------------
----------------------------------------------------------------------
----------------------------------------------------------------------
----------------------------------------------------------------------
----------------------------------------------------------------------
----------------------------------------------------------------------
----------------------------------------------------------------------
----------------------------------------------------------------------
----------------------------------------------------------------------
----------------------------------------------------------------------
----------------------------------------------------------------------
----------------------------------------------------------------------
----------------------------------------------------------------------
----------------------------------------------------------------------
----------------------------------------------------------------------
----------------------------------------------------------------------
----------------------------------------------------------------------
----------------------------------------------------------------------
----------------------------------------------------------------------
----------------------------------------------------------------------
----------------------------------------------------------------------
----------------------------------------------------------------------
----------------------------------------------------------------------
----------------------------------------------------------------------
----------------------------------------------------------------------
----------------------------------------------------------------------
----------------------------------------------------------------------
----------------------------------------------------------------------
----------------------------------------------------------------------
----------------------------------------------------------------------
----------------------------------------------------------------------
----------------------------------------------------------------------
----------------------------------------------------------------------
----------------------------------------------------------------------
----------------------------------------------------------------------
----------------------------------------------------------------------
----------------------------------------------------------------------
