GGGGGGGGGGGGGGGGGGGGGGGGGGGGGGGGGGGGGGGGGGGGGGGGGGG-------------------
G------------------------------------------------G--------------------
G------------------------------------------------G--------------------
G------------------------------------------------G--------------------
G------------------------------------------------G--------------------
G------------------------------------------------G--------------------
G------------------------------------------------G--------------------
G------------------------------------------------G--------------------
G------------------------------------------------G--------------------
G------------------------------------------------G--------------------
G------------------------------------------------G--------------------
G------------------------------------------------G--------------------
G------------------------------------------------G--------------------
G------------------------------------------------G--------------------
G------------------------------------------------G--------------------
G------------------------------------------------G--------------------
G------------------------------------------------G--------------------
G------------------------------------------------G--------------------
G------------------------------------------------G--------------------
G------------------------------------------------G--------------------
G------------------------------------------------G--------------------
G------------------------------------------------G--------------------
G------------------------------------------------G--------------------
G------------------------------------------------G--------------------
G-S----------------------------------------------G--------------------
G------------------------------------------------G--------------------
GGGGGGGGGGGGGGGGGGGGGGGGGGGGGGGGGGGGGGGGGGGGGGGGGGG-------------------
GGGGGGGGGGGGGGGGGGGGGGGGGGGGGGGGGGGGGGGGGGGGGGGGGGG-------------------
GGGGGGGGGGGGGGGGGGGGGGGGGGGGGGGGGGGGGGGGGGGGGGGGGGG-------------------
----------------------------------------------------------------------
----------------------------------------------------------------------
----------------------------------------------------------------------
----------------------------------------------------------------------
----------------------------------------------------------------------
----------------------------------------------------------------------
----------------------------------------------------------------------
----------------------------------------------------------------------
----------------------------------------------------------------------
----------------------------------------------------------------------
----------------------------------------------------------------------
----------------------------------------------------------------------
----------------------------------------------------------------------
----------------------------------------------------------------------
----------------------------------------------------------------------
----------------------------------------------------------------------
----------------------------------------------------------------------
----------------------------------------------------------------------
----------------------------------------------------------------------
----------------------------------------------------------------------
----------------------------------------------------------------------
----------------------------------------------------------------------
----------------------------------------------------------------------
----------------------------------------------------------------------
----------------------------------------------------------------------
----------------------------------------------------------------------
----------------------------------------------------------------------
----------------------------------------------------------------------
----------------------------------------------------------------------
----------------------------------------------------------------------
----------------------------------------------------------------------
----------------------------------------------------------------------
----------------------------------------------------------------------
----------------------------------------------------------------------
----------------------------------------------------------------------
----------------------------------------------------------------------
----------------------------------------------------------------------
----------------------------------------------------------------------
----------------------------------------------------------------------
----------------------------------------------------------------------
----------------------------------------------------------------------
