GGGGGGGGGGGGGGGGGGGGGGGGGGGGGGGGGGGGGGGGGGGGGGGGG---------------------
G---cccccc-------------------------------------G----------------------
G----------------------------------------------G----------------------
G----------------------------------------------G----------------------
G----------------------------------------------G----------------------
G----------------------------------------------G----------------------
G----------------------------------------------G----------------------
G-----------cGGGGGGGGGGGGGGGGGGGGGGGGc---------G----------------------
G-------------c----------c---------c-----------G----------------------
G----------------------------------------------G----------------------
Gc-------------GGGGGGGGGG---------------------cG----------------------
Gc-------------G--------G---------------------cG----------------------
Gc-------------G--------G---------------------cG----------------------
Gc-------------G---S----G---------------------cG----------------------
Gc-------------G---G----GGGGGG-lG-------------cG----------------------
Gc-------------GG-------G---------------------cG----------------------
Gc--S-----------GGGGGGGGG---------------------cG----------------------
Gc---------------------------------------------G----------------------
G-----cccccccccc-------------------------------G----------------------
GGGGGGGGGGGGGGGGGGGGGGLLLLGLLLGGGGGGGGGGGGGGGGGGG---------------------
GGGGGGGGGGGGGGGGGGGGGGGGGGGGGGGGGGGGGGGGGGGGGGGGG---------------------
GGGGGGGGGGGGGGGGGGGGGGGGGGGGGGGGGGGGGGGGGGGGGGGGG---------------------
----------------------------------------------------------------------
----------------------------------------------------------------------
----------------------------------------------------------------------
----------------------------------------------------------------------
----------------------------------------------------------------------
----------------------------------------------------------------------
----------------------------------------------------------------------
----------------------------------------------------------------------
----------------------------------------------------------------------
----------------------------------------------------------------------
----------------------------------------------------------------------
----------------------------------------------------------------------
----------------------------------------------------------------------
----------------------------------------------------------------------
----------------------------------------------------------------------
----------------------------------------------------------------------
----------------------------------------------------------------------
----------------------------------------------------------------------
----------------------------------------------------------------------
----------------------------------------------------------------------
----------------------------------------------------------------------
----------------------------------------------------------------------
----------------------------------------------------------------------
----------------------------------------------------------------------
----------------------------------------------------------------------
----------------------------------------------------------------------
----------------------------------------------------------------------
----------------------------------------------------------------------
----------------------------------------------------------------------
----------------------------------------------------------------------
----------------------------------------------------------------------
----------------------------------------------------------------------
----------------------------------------------------------------------
----------------------------------------------------------------------
----------------------------------------------------------------------
----------------------------------------------------------------------
----------------------------------------------------------------------
----------------------------------------------------------------------
----------------------------------------------------------------------
----------------------------------------------------------------------
----------------------------------------------------------------------
----------------------------------------------------------------------
----------------------------------------------------------------------
----------------------------------------------------------------------
----------------------------------------------------------------------
----------------------------------------------------------------------
----------------------------------------------------------------------
----------------------------------------------------------------------
