GGGGGGGGGGGGGGGGGGGGGGGGGGGGGGGGGGGGGGGGGGGGGGGGGGG-------------------
G-----------------------------------------------GG--------------------
G----K------------------------------------------GG--------------------
G----^GB-----GB-----GB-----GB-----GB-----GB-----GG--------------------
G---^GGB-----GB-----GB-----GB-----GB-----GB-----GG--------------------
G----^GGGGGGGGGGGGGGGGGGGGGGGGGGGGGGGGGGGGGGGG---G--------------------
G-----Ge-----K----------------------------------^G--------------------
GGB---G-----------------------------------------^G--------------------
G-----G-----------------------------------------^G--------------------
G-----G-----------------------------------------^G--------------------
G----GG^-------------NNN-------NNN--------------^G--------------------
G-----GLLLLLLLLLLLLLLLLLG-----GLLLLLLLLLLLLLLLLLLG--------------------
G-----GGGGGGGGGGGGGGGGGGGM----GGGGGGGGGGGGGGGGGGGG--------------------
GGB---G-----------------GM-----------------------G--------------------
G-----G-----------------G------------------------G--------------------
G-----G------------^----G------------------------G--------------------
G----GG------------G---MG------------------------G--------------------
G-----G------------G---MGGGGGGGGGGGGGGGGGGGGGGG--G--------------------
G-----G------------G-----------------------------G--------------------
GGB---G------------G-----------------------------G--------------------
G-----G------------GMB------MGMB------MGMB------MG--------------------
G-----G-----------MGMB------MGMB------MGMB------MG--------------------
G----GG------^----MGMB------MGMB------MGMB------MG--------------------
G-----G-----^G^----GMB------MGMB------MGMB------MG--------------------
G-S---GD^----^---N-GMB------MGMB------MGMB------MG--------------------
G-----GGGLLLLLLLLLLGMB------MGMB------MGMB------MG--------------------
GGGGGGGGGGGGGGGGGGGGGGGGGGGGGGGGGGGGGGGGGGGGGGGGGGG-------------------
GGGGGGGGGGGGGGGGGGGGGGGGGGGGGGGGGGGGGGGGGGGGGGGGGGG-------------------
GGGGGGGGGGGGGGGGGGGGGGGGGGGGGGGGGGGGGGGGGGGGGGGGGGG-------------------
----------------------------------------------------------------------
----------------------------------------------------------------------
----------------------------------------------------------------------
----------------------------------------------------------------------
----------------------------------------------------------------------
----------------------------------------------------------------------
----------------------------------------------------------------------
----------------------------------------------------------------------
----------------------------------------------------------------------
----------------------------------------------------------------------
----------------------------------------------------------------------
----------------------------------------------------------------------
----------------------------------------------------------------------
----------------------------------------------------------------------
----------------------------------------------------------------------
----------------------------------------------------------------------
----------------------------------------------------------------------
----------------------------------------------------------------------
----------------------------------------------------------------------
----------------------------------------------------------------------
----------------------------------------------------------------------
----------------------------------------------------------------------
----------------------------------------------------------------------
----------------------------------------------------------------------
----------------------------------------------------------------------
----------------------------------------------------------------------
----------------------------------------------------------------------
----------------------------------------------------------------------
----------------------------------------------------------------------
----------------------------------------------------------------------
----------------------------------------------------------------------
----------------------------------------------------------------------
----------------------------------------------------------------------
----------------------------------------------------------------------
----------------------------------------------------------------------
----------------------------------------------------------------------
----------------------------------------------------------------------
----------------------------------------------------------------------
----------------------------------------------------------------------
----------------------------------------------------------------------
----------------------------------------------------------------------
