GGGGGGGGGGGGGGGGGGGGGGGGGGGGGGGGGGGGGGGGGGGGGGGGGGG-------------------
G-----------------------------------------------GG--------------------
G----KGB-----GB-----GB-----GB-----GB-----GB-----GG--------------------
G----^GB-----GB-----GB-----GB-----GB-----GB-----GG--------------------
G---^GGB-----GB-----GB-----GB-----GB-----GB-----GG--------------------
G----^GGGGGGGGGGGGGGGGGGGGGGGGGGGGGGGGGGGGGGGG---G--------------------
GGB---Ge-----K-------------l--------------------^G--------------------
G-----G-----------------------------------------^G--------------------
G-----G-----------------------------------------^G--------------------
G---^GG-----------------------------------------^G--------------------
G----^G^--------------NNN^i-i^NNN---------------^G--------------------
G-----GLLLLLLLLLLLLLLLLLLGM--GLLLLLLLLLLLLLLLLLLLG--------------------
GGB---GGGGGGGGGGGGGGGGGGGGM--GGGGGGGGGGGGGGGGGGGGG--------------------
G-----G-----------------G----------^-----^-------G--------------------
G-----G-----------------Ge-----------------------G--------------------
G---^GG------------^----G------------------------G--------------------
G----^G------------G---MG-------^-----^------^---G--------------------
G-----G------------G---MGGGGGGGGGGGGGGGGGGGGGGG--G--------------------
GGB---G------------G-----------------------------G--------------------
G-----G------------G---------^---------^---------G--------------------
G-----G------------GMB------MGMB------MGMB------MG--------------------
G---^GG-----------MGMB------MGMB------MGMB------MG--------------------
G----^G---^---^---MGMB------MGMB------MGMB------MG--------------------
G-----G--^G^-^G^---GMB------MGMB------MGMB------MG--------------------
GS----GD^-^---^--N-GMB------MGMB------MGMB------MG--------------------
GG----GGGLLLLLLLLLLGMB------MGMB------MGMB------MG--------------------
GGGGGGGGGGGGGGGGGGGGGGGGGGGGGGGGGGGGGGGGGGGGGGGGGGG-------------------
GGGGGGGGGGGGGGGGGGGGGGGGGGGGGGGGGGGGGGGGGGGGGGGGGGG-------------------
GGGGGGGGGGGGGGGGGGGGGGGGGGGGGGGGGGGGGGGGGGGGGGGGGGG-------------------
----------------------------------------------------------------------
----------------------------------------------------------------------
----------------------------------------------------------------------
----------------------------------------------------------------------
----------------------------------------------------------------------
----------------------------------------------------------------------
----------------------------------------------------------------------
----------------------------------------------------------------------
----------------------------------------------------------------------
----------------------------------------------------------------------
----------------------------------------------------------------------
----------------------------------------------------------------------
----------------------------------------------------------------------
----------------------------------------------------------------------
----------------------------------------------------------------------
----------------------------------------------------------------------
----------------------------------------------------------------------
----------------------------------------------------------------------
----------------------------------------------------------------------
----------------------------------------------------------------------
----------------------------------------------------------------------
----------------------------------------------------------------------
----------------------------------------------------------------------
----------------------------------------------------------------------
----------------------------------------------------------------------
----------------------------------------------------------------------
----------------------------------------------------------------------
----------------------------------------------------------------------
----------------------------------------------------------------------
----------------------------------------------------------------------
----------------------------------------------------------------------
----------------------------------------------------------------------
----------------------------------------------------------------------
----------------------------------------------------------------------
----------------------------------------------------------------------
----------------------------------------------------------------------
----------------------------------------------------------------------
----------------------------------------------------------------------
----------------------------------------------------------------------
----------------------------------------------------------------------
----------------------------------------------------------------------
