GGGGGGGGGGGGGGGGGGGGGGGGGGGGGGGGGGGGGGGGGGGGGGGGGGG-------------------
G-l-l-------------------------------------------GG--------------------
G---K^GB-----GB-----GB------B-----GB-----GB-----GG--------------------
G----^GB-----GB-----GB------B-----GB-----GB-----GG--------------------
G---^GGB-----GB-----GB------B-----GB-----GB-----GG--------------------
G----^GGGGGGGGGGGGGGGGGGGGGGGGGGGGGGGGGGGGGGGG---G--------------------
GGB---Ge-----K-------------l--------------------^G--------------------
G-----G---------^--------------------^----------^G--------------------
G-----G--------MGM------------------MGM---------^G--------------------
G---^GG--------MGM------------------MGM---------^G--------------------
G----^G^--------^------NNN^-^NNN-----^----------^G--------------------
G-----GLLLLLLLLLLLLLLLLLLLGMGLLLLLLLLLLLLLLLLLLLLG--------------------
GGB---GGGGGGGGGGGGGGGGGGGGGMGGGGGGGGGGGGGGGGGGGGGG--------------------
G-----G---------------e-G----------^^----^^------G--------------------
G-----G-----------------Ge-----------------------G--------------------
G---^GG------------^----G------------------------G--------------------
G----^G------------G---MG-------^^----^^-----^^--G--------------------
G-----G------------G---MGGGGGGGGGGGGGGGGGGGGGGG--G--------------------
GGB---G------------G-----------------------------G--------------------
G-----G------------G---------^---------^---------G--------------------
G-----G------------GMB------MGMB------MGMB------MG--------------------
G---^GG------------GMB------MGMB------MGMB------MG--------------------
G----^G---^---^----GM------BMGM------BMGM------BMG--------------------
G-----G--^G^-^G^---GMB------MGMB------MGMB------MG--------------------
GS----GD^-^---^--N-GMB------MGMB------MGMB------MG--------------------
GG-l--GGGLLLLLLLLLLGMB------MGMB------MGMB------MG--------------------
GGGGGGGGGGGGGGGGGGGGGGGGGGGGGGGGGGGGGGGGGGGGGGGGGGG-------------------
GGGGGGGGGGGGGGGGGGGGGGGGGGGGGGGGGGGGGGGGGGGGGGGGGGG-------------------
GGGGGGGGGGGGGGGGGGGGGGGGGGGGGGGGGGGGGGGGGGGGGGGGGGG-------------------
----------------------------------------------------------------------
----------------------------------------------------------------------
----------------------------------------------------------------------
----------------------------------------------------------------------
----------------------------------------------------------------------
----------------------------------------------------------------------
----------------------------------------------------------------------
----------------------------------------------------------------------
----------------------------------------------------------------------
----------------------------------------------------------------------
----------------------------------------------------------------------
----------------------------------------------------------------------
----------------------------------------------------------------------
----------------------------------------------------------------------
----------------------------------------------------------------------
----------------------------------------------------------------------
----------------------------------------------------------------------
----------------------------------------------------------------------
----------------------------------------------------------------------
----------------------------------------------------------------------
----------------------------------------------------------------------
----------------------------------------------------------------------
----------------------------------------------------------------------
----------------------------------------------------------------------
----------------------------------------------------------------------
----------------------------------------------------------------------
----------------------------------------------------------------------
----------------------------------------------------------------------
----------------------------------------------------------------------
----------------------------------------------------------------------
----------------------------------------------------------------------
----------------------------------------------------------------------
----------------------------------------------------------------------
----------------------------------------------------------------------
----------------------------------------------------------------------
----------------------------------------------------------------------
----------------------------------------------------------------------
----------------------------------------------------------------------
----------------------------------------------------------------------
----------------------------------------------------------------------
----------------------------------------------------------------------
