GGGGGGGGGGGGGGGGGGGGGGGGGGGGGGGGGGGGGGGGGGGGGGGGGGG-------------------
G-----------------------------------------------GG--------------------
G-----D-----------------------------------------GG--------------------
G-----GB------B------B------B------B------B-----GG--------------------
G-----GB------B------B------B------B------B-----GG--------------------
GB---MGB------B------B------B------B------B-----GG--------------------
GB---MG-GGGGGGGGGG^GGGGGGGGGGGGGGGGGGGGGGGGGGG---G--------------------
G----MG------------------KG----e---e---e---------G--------------------
G----MGM------------------G---------------------MG--------------------
GM---BG-------------------G----------------------G--------------------
GM---BG-------------------G-^--------------------G--------------------
GM----G^------^^^-^^------GMG--------------------G--------------------
GM----GGGGGGGGGGG^GGGGGGGGGMGGGGGGGGGGGGGGGGGGGGGG--------------------
GB---MG------------------KG---------c----c----c--G--------------------
GB---MG-------------------G----------------------G--------------------
G----MGM-GGGGGGG--GGGGGG--GM--------------------cG--------------------
G----MGM-G----------------G----------------------G--------------------
GM---BG--G----------------G----------------------G--------------------
GM---BG-------------------^----------------------G--------------------
GM----G-MG-----pp---------GM---------------------G--------------------
G-----G-MG----------------G----------------------G--------------------
G-----G-MG----------------G----NNNNNNNNN---------G--------------------
G----KG-------------------GLLLLLLLLLLLLLLLLLLG---G--------------------
GGGGGGGGGGGGGGGGGGGGGGGG-MGGGGGGGGGGGGGGGGGGGG---G--------------------
GS-^---^---^---^---^---^---^---^---^---^---^-----G--------------------
G----^---^---^---^---^---^---^---^---^---^---^---G--------------------
GGGGGGGGGGGGGGGGGGGGGGGGGGGGGGGGGGGGGGGGGGGGGGGGGGG-------------------
GGGGGGGGGGGGGGGGGGGGGGGGGGGGGGGGGGGGGGGGGGGGGGGGGGG-------------------
GGGGGGGGGGGGGGGGGGGGGGGGGGGGGGGGGGGGGGGGGGGGGGGGGGG-------------------
----------------------------------------------------------------------
----------------------------------------------------------------------
----------------------------------------------------------------------
----------------------------------------------------------------------
----------------------------------------------------------------------
----------------------------------------------------------------------
----------------------------------------------------------------------
----------------------------------------------------------------------
----------------------------------------------------------------------
----------------------------------------------------------------------
----------------------------------------------------------------------
----------------------------------------------------------------------
----------------------------------------------------------------------
----------------------------------------------------------------------
----------------------------------------------------------------------
----------------------------------------------------------------------
----------------------------------------------------------------------
----------------------------------------------------------------------
----------------------------------------------------------------------
----------------------------------------------------------------------
----------------------------------------------------------------------
----------------------------------------------------------------------
----------------------------------------------------------------------
----------------------------------------------------------------------
----------------------------------------------------------------------
----------------------------------------------------------------------
----------------------------------------------------------------------
----------------------------------------------------------------------
----------------------------------------------------------------------
----------------------------------------------------------------------
----------------------------------------------------------------------
----------------------------------------------------------------------
----------------------------------------------------------------------
----------------------------------------------------------------------
----------------------------------------------------------------------
----------------------------------------------------------------------
----------------------------------------------------------------------
----------------------------------------------------------------------
----------------------------------------------------------------------
----------------------------------------------------------------------
----------------------------------------------------------------------
