GGGGGGGGGGGGGGGGGGGGGGGGGGGGGGGGGGGGGGGGGGGGGGGGGGG-------------------
G-----------------------------------------------GG--------------------
G-----GB------B------B------B------B------B-----GG--------------------
GB----GB------B------B------B------B------B-----GG--------------------
GB----GB------B------B------B------B------B-----GG--------------------
GB----GB------B------B------B------B------B-----GG--------------------
G-----G-GGGGGGGGGG^GGGGGGGGGGGGGGGGGGGGGGGGGGG---G--------------------
G-----G------------------KG----e---e---e---------G--------------------
G----BGM------------------G---------------------MG--------------------
G----BG-------------------G----------------------G--------------------
G-----G-------------------G-^--------------------G--------------------
G-----G^------^^^-^^------GMG---------B----------G--------------------
G-----GGGGGGGGGGG^GG-GGGGGGMGGGGGGGGGGGGGGGGGGGGGG--------------------
GB----G------------------KG---------c----c----c--G--------------------
GB----G-------------------G----------------------G--------------------
G-----GM-GGGGGGG--GGGGG---GM--------------------cG--------------------
G-----GM-G----------------G----------------------G--------------------
G----BG--G----------------G----------------------G--------------------
G----BG-------------------^----------------------G--------------------
G----BG-MG-----pp---------GM---------------------G--------------------
G-----G-MG----------------G----------------------G--------------------
G-----G-------------------G------NNNNNNN---------G--------------------
GD----G-------------------GLLLLLLLLLLLLLLLLLLG---G--------------------
GGGGGGGGGGGGGGGGGGGGGGGG-MGGGGGGGGGGGGGGGGGGGG---G--------------------
GS-----------------------------------------------G--------------------
G--B----------------------BB--------------------BG--------------------
GGGGGGGGGGGGGGGGGGGGGGGGGGGGGGGGGGGGGGGGGGGGGGGGGGG-------------------
GGGGGGGGGGGGGGGGGGGGGGGGGGGGGGGGGGGGGGGGGGGGGGGGGGG-------------------
GGGGGGGGGGGGGGGGGGGGGGGGGGGGGGGGGGGGGGGGGGGGGGGGGGG-------------------
----------------------------------------------------------------------
----------------------------------------------------------------------
----------------------------------------------------------------------
----------------------------------------------------------------------
----------------------------------------------------------------------
----------------------------------------------------------------------
----------------------------------------------------------------------
----------------------------------------------------------------------
----------------------------------------------------------------------
----------------------------------------------------------------------
----------------------------------------------------------------------
----------------------------------------------------------------------
----------------------------------------------------------------------
----------------------------------------------------------------------
----------------------------------------------------------------------
----------------------------------------------------------------------
----------------------------------------------------------------------
----------------------------------------------------------------------
----------------------------------------------------------------------
----------------------------------------------------------------------
----------------------------------------------------------------------
----------------------------------------------------------------------
----------------------------------------------------------------------
----------------------------------------------------------------------
----------------------------------------------------------------------
----------------------------------------------------------------------
----------------------------------------------------------------------
----------------------------------------------------------------------
----------------------------------------------------------------------
----------------------------------------------------------------------
----------------------------------------------------------------------
----------------------------------------------------------------------
----------------------------------------------------------------------
----------------------------------------------------------------------
----------------------------------------------------------------------
----------------------------------------------------------------------
----------------------------------------------------------------------
----------------------------------------------------------------------
----------------------------------------------------------------------
----------------------------------------------------------------------
----------------------------------------------------------------------
