GGGGGGGGGGGGGGGGGGGGGGGGGGGGGGGGGGGGGGGGGGGGGGGGGGG-------------------
G-----------------------------------------------GG--------------------
G-----GB------B------B------B------B------B-----GG--------------------
G-----GB------B------B------B------B------B-----GG--------------------
GB----GB------B------B------B------B------B-----GG--------------------
GB---MGB------B------B------B------B------B-----GG--------------------
GB---MG-GGGGGGGGGG^GGGGGGGGGGGGGGGGGGGGGGGGGGG---G--------------------
G----MG------------------KG----e---e---e---e-----G--------------------
GM----GM------------------G---------------------MG--------------------
GM---BG-------------------G----------------------G--------------------
GM---BG-------------------G-^--------------------G--------------------
GM----G^-----^^^^-^------DGMGK--------BB---------G--------------------
G----MGGGGGGGGGGG^GG^GGGGGGMGGGGGGGGGGGGGGGGGGGGGG--------------------
GB---MG------------------KG---------c----c----c--G--------------------
GB---MG-------------------G----------------------G--------------------
G----MGM-GGGGGGG---GGGG---GM--------------------cG--------------------
G-----GM-G----------------G----------------------G--------------------
GM---BG--G----------------G----------------------G--------------------
GM---B^-------------------^----------------------G--------------------
GM---BG-MG-----pp---------GM-------K-------------G--------------------
G-----G-MG----------------G---------------------cG--------------------
G-----G-------------------G-------NNNNNN---------G--------------------
G----KG-------------------GLLLLLLLLLLLLLLLLLLG---G--------------------
GGGGGGGGGGGGGGG^GGGGGGGG-MGGGGGGGGGGGGGGGGGGGG---G--------------------
GS-----------------------------------------------G--------------------
G--B----------------------BB--------------------BG--------------------
GGGGGGGGGGGGGGGGGGGGGGGGGGGGGGGGGGGGGGGGGGGGGGGGGGG-------------------
GGGGGGGGGGGGGGGGGGGGGGGGGGGGGGGGGGGGGGGGGGGGGGGGGGG-------------------
GGGGGGGGGGGGGGGGGGGGGGGGGGGGGGGGGGGGGGGGGGGGGGGGGGG-------------------
----------------------------------------------------------------------
----------------------------------------------------------------------
----------------------------------------------------------------------
----------------------------------------------------------------------
----------------------------------------------------------------------
----------------------------------------------------------------------
----------------------------------------------------------------------
----------------------------------------------------------------------
----------------------------------------------------------------------
----------------------------------------------------------------------
----------------------------------------------------------------------
----------------------------------------------------------------------
----------------------------------------------------------------------
----------------------------------------------------------------------
----------------------------------------------------------------------
----------------------------------------------------------------------
----------------------------------------------------------------------
----------------------------------------------------------------------
----------------------------------------------------------------------
----------------------------------------------------------------------
----------------------------------------------------------------------
----------------------------------------------------------------------
----------------------------------------------------------------------
----------------------------------------------------------------------
----------------------------------------------------------------------
----------------------------------------------------------------------
----------------------------------------------------------------------
----------------------------------------------------------------------
----------------------------------------------------------------------
----------------------------------------------------------------------
----------------------------------------------------------------------
----------------------------------------------------------------------
----------------------------------------------------------------------
----------------------------------------------------------------------
----------------------------------------------------------------------
----------------------------------------------------------------------
----------------------------------------------------------------------
----------------------------------------------------------------------
----------------------------------------------------------------------
----------------------------------------------------------------------
----------------------------------------------------------------------
