GGGGGGGGGGGGGGGGGGGGGGGGGGGGGGGGGGGGGGGGGGGGGGGGGGG-------------------
G----------^------^------^---------------------DGG--------------------
G-----G---^G^----^G^----^G^--------------------GGG--------------------
G-----G-------G------G------GM----^------^------GG--------------------
G-----G--------------------------MGM----MGM-----GG--------------------
G--G--G--G^^^^^^^^^^^^^^^^^^^^^^^^^^^^^^^^^^^GM-GG--------------------
GMGG--G--GGGGGGGGGGGGGGGGGGGGGGGGGGGGGGGGGGGGG---G--------------------
G-----G------------------KG----------------------G--------------------
G-----GM------------------G----------------------G--------------------
GM---MG-------------------G----------------G-----G--------------------
GM-p--G-------------------G-------------^--------G--------------------
GM----G^--B--^^^^-^-------G------------MG^-------G--------------------
G-----GGGGGGGGGGG^GG^GGGGGG-------------^--------G--------------------
G----MG------------------KG-------------------^--G--------------------
G----MG-------------------G-----i---B---i----^G^-G--------------------
G----MGM-GGGGGGG---GGGG---GK-B---GGGGGGG--B--^G^MG--------------------
GM----GM-G----------------GGGGGGGG-----GGGGGG-^-MG--------------------
GM----G--G----------------G^^^^^-----------------G--------------------
GM----G-------------------^--------^G^-----------G--------------------
G-----G-MG-----pp---------G----^---^G^-----------G--------------------
G-----G-------------------G^-N^G^N-^G^-NNN------^G--------------------
G-----G-------------------G----^----^------------G--------------------
G----KG-----^^--^^^-------G----^-----------------G--------------------
GGGGGGGGGGGGGGG^GGGGGGGG-MG^N-^G^----------------G--------------------
GS-----^^----------------------^-----------------G--------------------
G---^^----^^-------^^----------------------------G--------------------
GGGGGGGGGGGGGGGGGGGGGGGGGGGGGGGGGGGGGGGGGGGGGGGGGGG-------------------
GGGGGGGGGGGGGGGGGGGGGGGGGGGGGGGGGGGGGGGGGGGGGGGGGGG-------------------
GGGGGGGGGGGGGGGGGGGGGGGGGGGGGGGGGGGGGGGGGGGGGGGGGGG-------------------
----------------------------------------------------------------------
----------------------------------------------------------------------
----------------------------------------------------------------------
----------------------------------------------------------------------
----------------------------------------------------------------------
----------------------------------------------------------------------
----------------------------------------------------------------------
----------------------------------------------------------------------
----------------------------------------------------------------------
----------------------------------------------------------------------
----------------------------------------------------------------------
----------------------------------------------------------------------
----------------------------------------------------------------------
----------------------------------------------------------------------
----------------------------------------------------------------------
----------------------------------------------------------------------
----------------------------------------------------------------------
----------------------------------------------------------------------
----------------------------------------------------------------------
----------------------------------------------------------------------
----------------------------------------------------------------------
----------------------------------------------------------------------
----------------------------------------------------------------------
----------------------------------------------------------------------
----------------------------------------------------------------------
----------------------------------------------------------------------
----------------------------------------------------------------------
----------------------------------------------------------------------
----------------------------------------------------------------------
----------------------------------------------------------------------
----------------------------------------------------------------------
----------------------------------------------------------------------
----------------------------------------------------------------------
----------------------------------------------------------------------
----------------------------------------------------------------------
----------------------------------------------------------------------
----------------------------------------------------------------------
----------------------------------------------------------------------
----------------------------------------------------------------------
----------------------------------------------------------------------
----------------------------------------------------------------------
