GGGGGGGGGGGGGGGGGGGGGGGGGGGGGGGGGGGGGGGGGGGGGGGGGGG-------------------
G----------^------^------^---------------------DGG--------------------
G-----G---^G^----^G^----^G^-------------------^GGG--------------------
G-----G-------G------GM-----^-----^------^------GG--------------------
G-----G--------------------MGM---MGM----MGM-----GG--------------------
GMG---G--G^^^^^^^^^^^^^^^^^^^^^^^^^^^^^^^^^^^GM-GG--------------------
G-----G-MGGGGGGGGGGGGGGGGGGGGGGGGGGGGGGGGGGGGG---G--------------------
G-----G------------------KGK---------------------G--------------------
G-----G-------------------G----^-----------------G--------------------
GM---MG-------------------GM--^G^----------G-----G--------------------
GM-p--G-------------------G-------^G^---^--------G--------------------
GM----G^^^^--^^^^-^-------G--------^---MG^-------G--------------------
G-----GGGGGGGGGGG^GG^GGGGGG-------------^--------G--------------------
G----MG------------------KG-------------------^--G--------------------
G----MG-------------------G-----i---B---i----^G^-G--------------------
G----MGM-GGGGGGG---GGGG---GK-B---GGGGGGG--B--^G^MG--------------------
GM----GM-GK---------------GGGGGGGG-----GGGGGG-^-MG--------------------
GM----G--G----------------G^^^^^----^------------G--------------------
GM----^-------------------^--------^G^-----------G--------------------
G-----G-MG-----pp---------G----^---^G^-----------G--------------------
G-----G-MG----------------^--N^G^N-^G^-NNN------^G--------------------
G-----G------------------GG----^----^------------G--------------------
G----KG-----^^--^^^------G^----^-----------------G--------------------
GGGGGGGGGGGGGGG^GGGGGGGG-G^-N-^G^----------------G--------------------
GS-----^^----------^^----------^-----------------G--------------------
G---^^----^^----^^----^^--^^^^^^-----------------G--------------------
GGGGGGGGGGGGGGGGGGGGGGGGGGGGGGGGGGGGGGGGGGGGGGGGGGG-------------------
GGGGGGGGGGGGGGGGGGGGGGGGGGGGGGGGGGGGGGGGGGGGGGGGGGG-------------------
GGGGGGGGGGGGGGGGGGGGGGGGGGGGGGGGGGGGGGGGGGGGGGGGGGG-------------------
----------------------------------------------------------------------
----------------------------------------------------------------------
----------------------------------------------------------------------
----------------------------------------------------------------------
----------------------------------------------------------------------
----------------------------------------------------------------------
----------------------------------------------------------------------
----------------------------------------------------------------------
----------------------------------------------------------------------
----------------------------------------------------------------------
----------------------------------------------------------------------
----------------------------------------------------------------------
----------------------------------------------------------------------
----------------------------------------------------------------------
----------------------------------------------------------------------
----------------------------------------------------------------------
----------------------------------------------------------------------
----------------------------------------------------------------------
----------------------------------------------------------------------
----------------------------------------------------------------------
----------------------------------------------------------------------
----------------------------------------------------------------------
----------------------------------------------------------------------
----------------------------------------------------------------------
----------------------------------------------------------------------
----------------------------------------------------------------------
----------------------------------------------------------------------
----------------------------------------------------------------------
----------------------------------------------------------------------
----------------------------------------------------------------------
----------------------------------------------------------------------
----------------------------------------------------------------------
----------------------------------------------------------------------
----------------------------------------------------------------------
----------------------------------------------------------------------
----------------------------------------------------------------------
----------------------------------------------------------------------
----------------------------------------------------------------------
----------------------------------------------------------------------
----------------------------------------------------------------------
----------------------------------------------------------------------
