GGGGGGGGGGGGGGGGGGGGGGGGGGGGGGGGGGGGGGGGGGGGGGGGGGG-------------------
G----G----l-----G-----l-----G-----l-----G------KGG--------------------
G---------------------------------------------^GGG--------------------
G----^----------^-----------^-----------^-------GG--------------------
G---MGM--^G^---MGM---^G^---MGM---^G^---MGM------GG--------------------
G--G^^^^^^^^^^^^^^^^^^^^^^^^^^^^^^^^^^^^^^^^^G--GG--------------------
G--GGGGGGGGGGGGGGGGGGGGGGGGGGGGGGGGGGGGGGGGGGG---G--------------------
GM-G---G---G---G---G---GKMGM---------------G-----G--------------------
G--G---G---G---G---G---G--G-G---G---G------G-GG^-G--------------------
G--GGM-G-MGGGM-G-MGGGM-G--G------------------G^--G--------------------
G-------------------------G-----------------MGM--G--------------------
G-------------------------G-----------------MG---G--------------------
G-------------------------G-G-------p--------G---G--------------------
G^^^^^^^^^^^^^^^^^^^^^^^--G------------------G-^GG--------------------
GGGGGGGGGGGGGGGGGGGGGGGGM-G------------------G--^G--------------------
G-^----^----^----^----^---GK-B------------B--G--MG--------------------
G-------------------------GGGGGGGGGGGGGGGGGGGG--MG--------------------
G-G----G----G----G----G---G^^^^^----^------------G--------------------
G-------------------------G^-------^G^-----------G--------------------
GK------------------------G^---^---^G^-NNN------^G--------------------
G-------------------------G^-N^G^N-^G^^^^^^^-^^^^G--------------------
G-------------------------G^--^G^--^GGGGGGGG-GGGGG--------------------
GLLLLLLLLLLLLLLLLLLLLLLLLLG^--^G^---^--G--------DG--------------------
GGGGGGGGGGGGGGGGGGGGGGGGGG^-N-^G^-----MGM^GM----GG--------------------
GS-----^^----^^----^^----------^----------^------G--------------------
G---^^B--------------B^^--^^^^^^^^^^^^^^^^^^^^^^^G--------------------
GGGGGGGGGGGGGGGGGGGGGGGGGGGGGGGGGGGGGGGGGGGGGGGGGGG-------------------
GGGGGGGGGGGGGGGGGGGGGGGGGGGGGGGGGGGGGGGGGGGGGGGGGGG-------------------
GGGGGGGGGGGGGGGGGGGGGGGGGGGGGGGGGGGGGGGGGGGGGGGGGGG-------------------
----------------------------------------------------------------------
----------------------------------------------------------------------
----------------------------------------------------------------------
----------------------------------------------------------------------
----------------------------------------------------------------------
----------------------------------------------------------------------
----------------------------------------------------------------------
----------------------------------------------------------------------
----------------------------------------------------------------------
----------------------------------------------------------------------
----------------------------------------------------------------------
----------------------------------------------------------------------
----------------------------------------------------------------------
----------------------------------------------------------------------
----------------------------------------------------------------------
----------------------------------------------------------------------
----------------------------------------------------------------------
----------------------------------------------------------------------
----------------------------------------------------------------------
----------------------------------------------------------------------
----------------------------------------------------------------------
----------------------------------------------------------------------
----------------------------------------------------------------------
----------------------------------------------------------------------
----------------------------------------------------------------------
----------------------------------------------------------------------
----------------------------------------------------------------------
----------------------------------------------------------------------
----------------------------------------------------------------------
----------------------------------------------------------------------
----------------------------------------------------------------------
----------------------------------------------------------------------
----------------------------------------------------------------------
----------------------------------------------------------------------
----------------------------------------------------------------------
----------------------------------------------------------------------
----------------------------------------------------------------------
----------------------------------------------------------------------
----------------------------------------------------------------------
----------------------------------------------------------------------
----------------------------------------------------------------------
