GGGGGGGGGGGGGGGGGGGGGGGGGGGGGGGGGGGGGGGGGGGGGGGGGG--------------------
G----G----G-----G-----G-----G-----G-----G------KGG--------------------
G---------------------------------------------^GGG--------------------
G----^----^-----^-----^-----^-----^-----^-------GG--------------------
G---MGM--MGM---MGM---MGM---MGM---MGM---MGM------GG--------------------
G--G^^^^^^^^^^^^^^^^^^^^^^^^^^^^^^^^^^^^^^^^^G--GG--------------------
G-GGGGGGGGGGGGGGGGGGGGGGGGGGGGGGGGGGGGGGGGGGGG---G--------------------
GMGGGKGGG-GGGGG-GGG-G-G-GGG-G--------------G-----G--------------------
G--G--GK--GKGKG-G-G-G-G-GK--G-G---G--------GMGG^^G--------------------
G--G--GGG-GMG-G-GGG-G-G-GGG-G----------------G^--G--------------------
G--G--GK--G---G-G---G-G--KG-G----------------GM--G--------------------
G-MG-MGGGMG--MGMGM-MGGGMGGGMG----------------G---G--------------------
G---------------------------G-G-----p-----G--G---G--------------------
G---------------------------G----------------G^^GG--------------------
G^^^^^^^^^^^^^^^^^^^^^^^----G----------------G--^G--------------------
GGGGGGGGGGGGGGGGGGGGGGGG--^-GKB-----------B--G--MG--------------------
G-^----^----^----^----^---GGGGGGGGGGGGGGGGGGGG--MG--------------------
G-------------------------G^^^^^----^------------G--------------------
G-G---^G---^G---^G---^G---G^-------^G^-----------G--------------------
GK----K----K----K----K----G^---^---^G^-NNN------^G--------------------
G-------------------------G^-N^G^N-^G^^^^^^^-^^^^G--------------------
G-------------------------G^--^G^--^GGGGGGGG-GGGGG--------------------
GLLLLLLLLLLLLLLLLLLLLLLLLLG^--^G^^--^--G--------KG--------------------
GGGGGGGGGGGGGGGGGGGGGGGGGG^-N-^G^GM---MGM^GM----GG--------------------
GS-----^^----^^----^^----------^----------^------G--------------------
GD--^^B--------------B^^----BB----^^^^^^^^^^^^^^^G--------------------
GGGGGGGGGGGGGGGGGGGGGGGGGGGGGGGGGGGGGGGGGGGGGGGGGGG-------------------
GGGGGGGGGGGGGGGGGGGGGGGGGGGGGGGGGGGGGGGGGGGGGGGGGGG-------------------
GGGGGGGGGGGGGGGGGGGGGGGGGGGGGGGGGGGGGGGGGGGGGGGGGGG-------------------
----------------------------------------------------------------------
----------------------------------------------------------------------
----------------------------------------------------------------------
----------------------------------------------------------------------
----------------------------------------------------------------------
----------------------------------------------------------------------
----------------------------------------------------------------------
----------------------------------------------------------------------
----------------------------------------------------------------------
----------------------------------------------------------------------
----------------------------------------------------------------------
----------------------------------------------------------------------
----------------------------------------------------------------------
----------------------------------------------------------------------
----------------------------------------------------------------------
----------------------------------------------------------------------
----------------------------------------------------------------------
----------------------------------------------------------------------
----------------------------------------------------------------------
----------------------------------------------------------------------
----------------------------------------------------------------------
----------------------------------------------------------------------
----------------------------------------------------------------------
----------------------------------------------------------------------
----------------------------------------------------------------------
----------------------------------------------------------------------
----------------------------------------------------------------------
----------------------------------------------------------------------
----------------------------------------------------------------------
----------------------------------------------------------------------
----------------------------------------------------------------------
----------------------------------------------------------------------
----------------------------------------------------------------------
----------------------------------------------------------------------
----------------------------------------------------------------------
----------------------------------------------------------------------
----------------------------------------------------------------------
----------------------------------------------------------------------
----------------------------------------------------------------------
----------------------------------------------------------------------
----------------------------------------------------------------------
