GGGGGGGGGGGGGGGGGGGGGGGGGGGGGGGGGGGGGGGGGGGGGGGGGGG
G------------------------------------------------G
G------------------------------------------------G
G------------------------------------------------G
G------------------------------------------------G
G------------------------------------------------G
G------------------------------------------------G
G------------------------------------------------G
G------------------------------------------------G
G------------------------------------------------G
G------------------------------------------------G
G------------------------------------------------G
G------------------------------------------------G
G------------------------------------------------G
G------------------------------------------------G
G------------------------------------------------G
G------------------------------------------------G
G------------------------------------------------G
G--------------GGGGGGGGGGGGGGGGGGGG--------------G
G--------------------------------e---------------G
G------------------------------------------------G
G------------------------------------------------G
G------------------------------------------------G
G----------i---------N----i----------------------G
G------------------------------------------------G
G---S---------------------GGG--------------------G
G-------------------------GGG--------------------G
GGGGGGGGGGGGGGLLLLLLGGGGGGGGGGGGGGGGGGGGGGGGGGGGGGG