GGGGGGGGGGGGGGGGGGGGGGGGGGGGGGGGGGGGGGGGGGGGGGGGGGG
G------------------------------------------------G
G------------------------------------------------G
G------------------------------------------------G
G------------------------------------------------G
G------------------------------------------------G
G------------------------------------------------G
G------------------------------------------------G
G------------------------------------------------G
G------------------------------------------------G
G------------------------------------------------G
G------------------------------------------------G
G------------------------------------------------G
G------------------------------------------------G
G------------------------------------------------G
G------------------------------------------------G
G------------------------------------------------G
G------------------------------------------------G
G--------------GGGGGGGGGGGGGGGGGGGG--------------G
G--------------------------------e---------------G
G------------------------------------------------G
G------------------------------------------------G
G------------------------------------------------G
G------------------------------------------------G
G------------------------------------------------G
G---S--------------------eGGG--------------------G
G------------------------eGGG--------------------G
GGGGGGGGGGGGGGLLLLLLGGGGGGGGGGGGGGGGGGGGGGGGGGGGGGG