GGGGGGGGGGGGGGGGGGGGGGGGGGGGGGGGGGGGGGGGGGGGGGGGGGG
G------------------------------------------------G
G------------------------------------------------G
G------------------------------------------------G
G------------------------------------------------G
G------------------------------------------------G
G------------------------------------------------G
G------------------------------------------------G
G------------------------------------------------G
G------------------------------------------------G
G------------------------------------------------G
G------------------------------------------------G
G------------------------------------------------G
G------------------------------------------------G
G------------------------------------------------G
G------------------------------------------------G
G------------------------------------------------G
G------------------------------------------------G
G--------------GGGGGGGGGGGGGGGGGGGG--------------G
G-----------------e------------e-----------------G
G------------------------------------------------G
Ge-----------------------------------------------G
G------------------------------------------------G
G------------------------------------------------G
G------------------------------------------------G
G---S--------------------eGGG--------------------G
G------------------------eGGG---e----------------G
GGGGGGGGGGGGGGGGGGGGGGGGGGGGGGGGGGGGGGGGGGGGGGGGGGGG