GGGGGGGGGGGGGGGGGGGGGGGGGGGGGGGGGGGGGGGGGGGGGGGGGGG-------------------
G-K-G^^^^^^^^^^^^^^^^^^^^^^^^^^^^^^^^^^^^^^^^^^^^G--------------------
G^--G-------------------------------------------^G--------------------
G^-^G^------------------------------------------^G--------------------
G^--^-----------N--------------N------------N---^G--------------------
G^---------------------------------------------N^G--------------------
G^-N------------------------N-------------------^G--------------------
G^----------------------------------------------^G--------------------
G^--------------------Gc------------------------^G--------------------
G^-------N--------------------------------------^G--------------------
G^-------------------------------------N--------^G--------------------
G^----------------------------------------------^G--------------------
G^------------------N------------------------N--^G--------------------
G^----------------------------------------------^G--------------------
G^------------N-Gc------------------------------^G--------------------
G^---N----------e------------N------------------^G--------------------
G^----------------------------------------------^G--------------------
G^------N---------------------------------------^G--------------------
G^---Gc-----------------------------------------^G--------------------
G^---------------------------------------------N^G--------------------
G^----------------N------------N--N-------------^G--------------------
G^----------------------------------------------^G--------------------
G^-------------------------------------------SD-^G--------------------
G^---N--------------------------------------N-G-^G--------------------
G^^^^^^^^^^^^^^^^^^^^^^^^^^^^^^^^^^^^^^^^^^^^^^^^G--------------------
GGGGGGGGGGGGGGGGGGGGGGGGGGGGGGGGGGGGGGGGGGGGGGGGGG--------------------
GGGGGGGGGGGGGGGGGGGGGGGGGGGGGGGGGGGGGGGGGGGGGGGGGG--------------------
GGGGGGGGGGGGGGGGGGGGGGGGGGGGGGGGGGGGGGGGGGGGGGGGGGG-------------------
----------------------------------------------------------------------
----------------------------------------------------------------------
----------------------------------------------------------------------
----------------------------------------------------------------------
----------------------------------------------------------------------
----------------------------------------------------------------------
----------------------------------------------------------------------
----------------------------------------------------------------------
----------------------------------------------------------------------
----------------------------------------------------------------------
----------------------------------------------------------------------
----------------------------------------------------------------------
----------------------------------------------------------------------
----------------------------------------------------------------------
----------------------------------------------------------------------
----------------------------------------------------------------------
----------------------------------------------------------------------
----------------------------------------------------------------------
----------------------------------------------------------------------
----------------------------------------------------------------------
----------------------------------------------------------------------
----------------------------------------------------------------------
----------------------------------------------------------------------
----------------------------------------------------------------------
----------------------------------------------------------------------
----------------------------------------------------------------------
----------------------------------------------------------------------
----------------------------------------------------------------------
----------------------------------------------------------------------
----------------------------------------------------------------------
----------------------------------------------------------------------
----------------------------------------------------------------------
----------------------------------------------------------------------
----------------------------------------------------------------------
----------------------------------------------------------------------
----------------------------------------------------------------------
----------------------------------------------------------------------
----------------------------------------------------------------------
----------------------------------------------------------------------
----------------------------------------------------------------------
----------------------------------------------------------------------
----------------------------------------------------------------------
