GGGGGGGGGGGGGGGGGGGGGGGGGGGGGGGGGGGGGGGGGGGGGGGGGGG-------------------
G-K-G^^^^^^^^^^^^^^l^^^^^^^^^^^^G-K-G^^l^^^^^^^^^G--------------------
G^-^G^--------------------------G---G-----------^G--------------------
G^-^G^--------------------------G---G-----------^G--------------------
G^--^-----------N--------------N------------N---^G--------------------
G^-----------------------^---------------------N^G--------------------
G^-N--------------------^G^-N-------------------^G--------------------
G^----------------------^G^---------------------^G--------------------
G^------------------N-Gc^G^---------------------^G--------------------
G^-------N--------------^G^---------------------^G--------------------
G^----------------------^G^------------N--------^G--------------------
G^----------------------^G^---------------------^G--------------------
G^------------------N---^G^------------------N--^G--------------------
G^----------------------lGl---------------------^G--------------------
G^------------N-Gc------^G^---------------------^G--------------------
G^---N------------------^G^--N------------------^G--------------------
G^----------------------^G^---------------------^G--------------------
G^------N---------------^G^---------------------^G--------------------
G^---Gc-----------------^G^---------------------^G--------------------
G^----------------------^G^--------------------N^G--------------------
G^----i-----------N------^-----N--N-------------^G--------------------
G^^^-^--------------------------------------S---^G--------------------
GGGG-G^-N----------------N----------N---------D-^G--------------------
GK---G^------------------------------------N-^G-^G--------------------
GGGGGG^^^^^l^^^^^^^^^^^^^^^^^^^^^^l^^^^^^^^^^^^^^G--------------------
GGGGGGGGGGGGGGGGGGGGGGGGGGGGGGGGGGGGGGGGGGGGGGGGGG--------------------
GGGGGGGGGGGGGGGGGGGGGGGGGGGGGGGGGGGGGGGGGGGGGGGGGG--------------------
GGGGGGGGGGGGGGGGGGGGGGGGGGGGGGGGGGGGGGGGGGGGGGGGGGG-------------------
----------------------------------------------------------------------
----------------------------------------------------------------------
----------------------------------------------------------------------
----------------------------------------------------------------------
----------------------------------------------------------------------
----------------------------------------------------------------------
----------------------------------------------------------------------
----------------------------------------------------------------------
----------------------------------------------------------------------
----------------------------------------------------------------------
----------------------------------------------------------------------
----------------------------------------------------------------------
----------------------------------------------------------------------
----------------------------------------------------------------------
----------------------------------------------------------------------
----------------------------------------------------------------------
----------------------------------------------------------------------
----------------------------------------------------------------------
----------------------------------------------------------------------
----------------------------------------------------------------------
----------------------------------------------------------------------
----------------------------------------------------------------------
----------------------------------------------------------------------
----------------------------------------------------------------------
----------------------------------------------------------------------
----------------------------------------------------------------------
----------------------------------------------------------------------
----------------------------------------------------------------------
----------------------------------------------------------------------
----------------------------------------------------------------------
----------------------------------------------------------------------
----------------------------------------------------------------------
----------------------------------------------------------------------
----------------------------------------------------------------------
----------------------------------------------------------------------
----------------------------------------------------------------------
----------------------------------------------------------------------
----------------------------------------------------------------------
----------------------------------------------------------------------
----------------------------------------------------------------------
----------------------------------------------------------------------
----------------------------------------------------------------------
