GGGGGGGGGGGGGGGGGGGGGGGGGGGGGGGGGGGGGGGGGGGGGGGGGGG-------------------
G-K-G^^^^^^^^^^^^^^l^^^^^^^^^^^^G---G^^l^^^^^^^^^G--------------------
G^-^G^--------------------------G-K-G-----------^G--------------------
G^-^G^--------------------------G---G-----------^G--------------------
G^--^--NK-N--------------------N------------N---^G--------------------
G^-----------------------^-----------N---------N^G--------------------
G^-N--------------------^G^-N-------------------^G--------------------
G^----------------------^G^---------------------^G--------------------
G^------------------N-Gc^G^-------N-------------^G--------------------
G^-------N--------------^G^---------------------^G--------------------
G^----------------------^G^----N-------N--------^G--------------------
G^----------------------^G^---------------------^G--------------------
G^------------------N---^G^-----N------------N--^G--------------------
G^----------------------lGl---------------------^G--------------------
G^------------N-Gc------^G^---------------------^G--------------------
G^---N------------------^G^--N--------N----N----^G--------------------
G^----------------------^G^---------------------^G--------------------
G^------N---------------^G^---------------------^G--------------------
G^---Gc-----------------^G^---------------------^G--------------------
G^----------------------^G^------N-------------N^G--------------------
G^----i-----------N------^-----N--N-------------^G--------------------
G^^^-^--------------------------------------S---^G--------------------
GGGG-G^-N----------------N----------N---------D-^G--------------------
GK---G^------------------------------------N-^G-^G--------------------
GGGGGG^^^^^l^^^^^^^^^^^^^^^^^^^^^^l^^^^^^^^^^^^^^G--------------------
GGGGGGGGGGGGGGGGGGGGGGGGGGGGGGGGGGGGGGGGGGGGGGGGGG--------------------
GGGGGGGGGGGGGGGGGGGGGGGGGGGGGGGGGGGGGGGGGGGGGGGGGG--------------------
GGGGGGGGGGGGGGGGGGGGGGGGGGGGGGGGGGGGGGGGGGGGGGGGGGG-------------------
----------------------------------------------------------------------
----------------------------------------------------------------------
----------------------------------------------------------------------
----------------------------------------------------------------------
----------------------------------------------------------------------
----------------------------------------------------------------------
----------------------------------------------------------------------
----------------------------------------------------------------------
----------------------------------------------------------------------
----------------------------------------------------------------------
----------------------------------------------------------------------
----------------------------------------------------------------------
----------------------------------------------------------------------
----------------------------------------------------------------------
----------------------------------------------------------------------
----------------------------------------------------------------------
----------------------------------------------------------------------
----------------------------------------------------------------------
----------------------------------------------------------------------
----------------------------------------------------------------------
----------------------------------------------------------------------
----------------------------------------------------------------------
----------------------------------------------------------------------
----------------------------------------------------------------------
----------------------------------------------------------------------
----------------------------------------------------------------------
----------------------------------------------------------------------
----------------------------------------------------------------------
----------------------------------------------------------------------
----------------------------------------------------------------------
----------------------------------------------------------------------
----------------------------------------------------------------------
----------------------------------------------------------------------
----------------------------------------------------------------------
----------------------------------------------------------------------
----------------------------------------------------------------------
----------------------------------------------------------------------
----------------------------------------------------------------------
----------------------------------------------------------------------
----------------------------------------------------------------------
----------------------------------------------------------------------
----------------------------------------------------------------------
