GGGGGGGGGGGGGGGGGGGGGGGGGGGGGGGGGGGGGGGGGGGGGGGGGGG-------------------
G-^^^^^^^^^^^c^^^^^^^^^^^^^^^^^^^c^^^^^^^^^^^^^^^G--------------------
G^----------------------------------------------^G--------------------
G^----------------------------------------------^G--------------------
G^----------------------------------------------^G--------------------
G^----------------------------------------------^G--------------------
G^----------------------------------------------^G--------------------
G^----------------------------------------------^G--------------------
G^----------------------------------------------^G--------------------
G^----------------------------------------------^G--------------------
G^----------------------------------------------^G--------------------
G^----------------------------------------------^G--------------------
G^-----------------------------------------S----^G--------------------
G^---------N-----------Ni-----------------------^G--------------------
G^--D-----N-------N-------N-------N-------N-----^G--------------------
G^--G-------------------------------------------^G--------------------
G^----------------------------------------------^G--------------------
G^----------------------------------------------^G--------------------
G^----------------------------------------------^G--------------------
G^----------------------------------------------^G--------------------
G^----------------------------------------------^G--------------------
G^----------------------------------------------^G--------------------
G^----------------------------------------------^G--------------------
G^----------------------------------------------^G--------------------
G^^^^^^^^^^^^c^^^^^^^^^^^^^^^^^^^c^^^^^^^^^^^^^^^G--------------------
GGGGGGGGGGGGGGGGGGGGGGGGGGGGGGGGGGGGGGGGGGGGGGGGGG--------------------
GGGGGGGGGGGGGGGGGGGGGGGGGGGGGGGGGGGGGGGGGGGGGGGGGG--------------------
GGGGGGGGGGGGGGGGGGGGGGGGGGGGGGGGGGGGGGGGGGGGGGGGGGG-------------------
----------------------------------------------------------------------
----------------------------------------------------------------------
----------------------------------------------------------------------
----------------------------------------------------------------------
----------------------------------------------------------------------
----------------------------------------------------------------------
----------------------------------------------------------------------
----------------------------------------------------------------------
----------------------------------------------------------------------
----------------------------------------------------------------------
----------------------------------------------------------------------
----------------------------------------------------------------------
----------------------------------------------------------------------
----------------------------------------------------------------------
----------------------------------------------------------------------
----------------------------------------------------------------------
----------------------------------------------------------------------
----------------------------------------------------------------------
----------------------------------------------------------------------
----------------------------------------------------------------------
----------------------------------------------------------------------
----------------------------------------------------------------------
----------------------------------------------------------------------
----------------------------------------------------------------------
----------------------------------------------------------------------
----------------------------------------------------------------------
----------------------------------------------------------------------
----------------------------------------------------------------------
----------------------------------------------------------------------
----------------------------------------------------------------------
----------------------------------------------------------------------
----------------------------------------------------------------------
----------------------------------------------------------------------
----------------------------------------------------------------------
----------------------------------------------------------------------
----------------------------------------------------------------------
----------------------------------------------------------------------
----------------------------------------------------------------------
----------------------------------------------------------------------
----------------------------------------------------------------------
----------------------------------------------------------------------
----------------------------------------------------------------------
