GGGGGGGGGGGGGGGGGGGGGGGGGGGGGGGGGGGGGGGGGGGGGGGGGGG-------------------
G-^^^^^^^^^^^c^^^^^^^^^^^^^^^^^^^c^^^^^^^^^^^^^^^G--------------------
G^----------------------------------------------^G--------------------
G^----------------------------------------------^G--------------------
G^----------------------------------------------^G--------------------
G^----------------------------------------------^G--------------------
G^----------------------------------------------^G--------------------
G^----------------^^-----K----------------------^G--------------------
G^---------------^GG^---^GG^--------------------^G--------------------
G^---------------^GG^---^GG^--------------------^G--------------------
G^---------------^GG^---^GG^N-----N------N-----N^G--------------------
G^---S-----------^GG^---^GG^--------------------^G--------------------
G^----------------^^-----^^---------------------^G--------------------
G^--------------------p----------------------D--^G--------------------
G^-N--------------i---------N---------------^G--^G--------------------
G^----------------i-----------------------------^G--------------------
G^---------------^GG^---^GG^K-------------------^G--------------------
G^---------------^GG^-N-^GG^--------------------^G--------------------
G^---------------^GG^---^GG^--------------------^G--------------------
G^---------------^GG^-B-^GG^--------------------^G--------------------
G^----------------^^-----^^---------------------^G--------------------
G^-----N----------------------------------------^G--------------------
G^------------------------i---------------------^G--------------------
G^----------------------------------------------^G--------------------
G^^^^^^^^^^^^c^^^^^^^^^^^^^^^^^^^^^^^^^^^^^^^^^^^G--------------------
GGGGGGGGGGGGGGGGGGGGGGGGGGGGGGGGGGGGGGGGGGGGGGGGGG--------------------
GGGGGGGGGGGGGGGGGGGGGGGGGGGGGGGGGGGGGGGGGGGGGGGGGG--------------------
GGGGGGGGGGGGGGGGGGGGGGGGGGGGGGGGGGGGGGGGGGGGGGGGGGG-------------------
----------------------------------------------------------------------
----------------------------------------------------------------------
----------------------------------------------------------------------
----------------------------------------------------------------------
----------------------------------------------------------------------
----------------------------------------------------------------------
----------------------------------------------------------------------
----------------------------------------------------------------------
----------------------------------------------------------------------
----------------------------------------------------------------------
----------------------------------------------------------------------
----------------------------------------------------------------------
----------------------------------------------------------------------
----------------------------------------------------------------------
----------------------------------------------------------------------
----------------------------------------------------------------------
----------------------------------------------------------------------
----------------------------------------------------------------------
----------------------------------------------------------------------
----------------------------------------------------------------------
----------------------------------------------------------------------
----------------------------------------------------------------------
----------------------------------------------------------------------
----------------------------------------------------------------------
----------------------------------------------------------------------
----------------------------------------------------------------------
----------------------------------------------------------------------
----------------------------------------------------------------------
----------------------------------------------------------------------
----------------------------------------------------------------------
----------------------------------------------------------------------
----------------------------------------------------------------------
----------------------------------------------------------------------
----------------------------------------------------------------------
----------------------------------------------------------------------
----------------------------------------------------------------------
----------------------------------------------------------------------
----------------------------------------------------------------------
----------------------------------------------------------------------
----------------------------------------------------------------------
----------------------------------------------------------------------
----------------------------------------------------------------------
