GGGGGGGGGGGGGGGGGGGGGGGGGGGGGGGGGGGGGGGGGGGGGGGGGG--------------------
G-------------------------------------GG---------G--------------------
G-------------------------------------GG---------G--------------------
G-------------------------------------GG-----G--MG--------------------
G-------------------------------------GG^---lG---G--------------------
G-------------------------------------GG^----GM--G--------------------
G-------------------------------------GG^---lG---G--------------------
G-------------------------------------GG^----G--MG--------------------
G-------------------------------------GG^---lG---G--------------------
G-------------------------------------GG^----GM--G--------------------
G---D---------------------------------GG^---lG---G--------------------
GGGGGGGGGGGGGGGGGGGGGGGGGGGGGM--------GG^----G--MG--------------------
G---------------------------GM--------GG^----G---G--------------------
G---------------------------GM--------GG^----GM--G--------------------
G---------------------------GM---------------G---G--------------------
G---------------------------GM--B---------i--G--MG--------------------
G---------------------------GGGGGGGGGGGG^^G^^G---G--------------------
G----S----------------------GGGGGGGGGGGGGGGGGGM--G--------------------
GGGGGG---------G--------G---Ge------------------MG--------------------
GGGGGG---------G--------G^--G-------------------MG--------------------
GGGGGG---------G--------G^--^---^GGGGGGGGGGGGGG-MG--------------------
GGGGGG---------G--------G^------^G--------------MG--------------------
GGGGGG---------G--------G^N-----^G--------------MG--------------------
GGGGGG---------G--------G^^^^^^^^G--GGGGGB--MGM-MG--------------------
GGGGGG-------GGG--------GGGGGGGGGG-----MG--BMGM-MG--------------------
GGGGGG-------^^G--------GGGGGGGGGGGGG--MG---MGM-MG--------------------
GGGGGG---------G^^^^^^^^Gl-----K------------MG-e-G--------------------
GGGGGGGGGGGGGGGGGGGGGGGGGGGGGGGGGGGGGGGGGGGGGGGGGG--------------------
----------------------------------------------------------------------
----------------------------------------------------------------------
----------------------------------------------------------------------
----------------------------------------------------------------------
----------------------------------------------------------------------
----------------------------------------------------------------------
----------------------------------------------------------------------
----------------------------------------------------------------------
----------------------------------------------------------------------
----------------------------------------------------------------------
----------------------------------------------------------------------
----------------------------------------------------------------------
----------------------------------------------------------------------
----------------------------------------------------------------------
----------------------------------------------------------------------
----------------------------------------------------------------------
----------------------------------------------------------------------
----------------------------------------------------------------------
----------------------------------------------------------------------
----------------------------------------------------------------------
----------------------------------------------------------------------
----------------------------------------------------------------------
----------------------------------------------------------------------
----------------------------------------------------------------------
----------------------------------------------------------------------
----------------------------------------------------------------------
----------------------------------------------------------------------
----------------------------------------------------------------------
----------------------------------------------------------------------
----------------------------------------------------------------------
----------------------------------------------------------------------
----------------------------------------------------------------------
----------------------------------------------------------------------
----------------------------------------------------------------------
----------------------------------------------------------------------
----------------------------------------------------------------------
----------------------------------------------------------------------
----------------------------------------------------------------------
----------------------------------------------------------------------
----------------------------------------------------------------------
----------------------------------------------------------------------
----------------------------------------------------------------------
