GGGGGGGGGGGGGGGGGGGGGGGGGGGGGGGGGGGGGGGGGGGGGGGGGG--------------------
G----------------e--------------------GG---------G--------------------
G-------------------------------------GG---------G--------------------
G-------------------------------------GG^-B--G--MG--------------------
G-------------------------------------GG^-B--G---G--------------------
G----------------p--------------------GG^----G---G--------------------
G-------------------------------------GG^----G---G--------------------
G-------------------------------------GG^----GM--G--------------------
G---D---------------------------------GG^----G---G--------------------
GGGGGGGGGGGGGGGGGGGGGGGGGGGGGM--------GG^---BG--MG--------------------
G---------------------------GM--------GG^---BG---G--------------------
G---------------------------GM--------GG^----GM--G--------------------
G---------------------------GM---------------G---G--------------------
G---------------------------GM--B---------i--G--MG--------------------
G---------------------------GGGGGGGGGGGG^^G^^G---G--------------------
G----S---------G--------G---GGGGGGGGGGGGGGGGGGM--G--------------------
GGGGGG---------G--------G---Ge------------------MG--------------------
GGGGGG---------G--K-----G^--G-------------------MG--------------------
GGGGGG---------G--------G^--^---^GGGGGGGGGGGGGG-MG--------------------
GGGGGG---------G--------G^------^G--------------MG--------------------
GGGGGG---------G--------G^N-----^G--------------MG--------------------
GGGGGG---------G--------G^^^^^^^^G--GGGGGB--MGM-MG--------------------
GGGGGG-------GGG--------GGGGGGGGGG-----MG--BMGM-MG--------------------
GGGGGG-------^^G--------GGGGGGGGGGGGG--MG---MGM-eG--------------------
GGGGGG---------G^^^^^^^^Gl-----K------------MGLLLG--------------------
GGGGGGGGGGGGGGGGGGGGGGGGGGGGGGGGGGGGGGGGGGGGGGGGGG--------------------
GGGGGGGGGGGGGGGGGGGGGGGGGGGGGGGGGGGGGGGGGGGGGGGGGG--------------------
GGGGGGGGGGGGGGGGGGGGGGGGGGGGGGGGGGGGGGGGGGGGGGGGGG--------------------
----------------------------------------------------------------------
----------------------------------------------------------------------
----------------------------------------------------------------------
----------------------------------------------------------------------
----------------------------------------------------------------------
----------------------------------------------------------------------
----------------------------------------------------------------------
----------------------------------------------------------------------
----------------------------------------------------------------------
----------------------------------------------------------------------
----------------------------------------------------------------------
----------------------------------------------------------------------
----------------------------------------------------------------------
----------------------------------------------------------------------
----------------------------------------------------------------------
----------------------------------------------------------------------
----------------------------------------------------------------------
----------------------------------------------------------------------
----------------------------------------------------------------------
----------------------------------------------------------------------
----------------------------------------------------------------------
----------------------------------------------------------------------
----------------------------------------------------------------------
----------------------------------------------------------------------
----------------------------------------------------------------------
----------------------------------------------------------------------
----------------------------------------------------------------------
----------------------------------------------------------------------
----------------------------------------------------------------------
----------------------------------------------------------------------
----------------------------------------------------------------------
----------------------------------------------------------------------
----------------------------------------------------------------------
----------------------------------------------------------------------
----------------------------------------------------------------------
----------------------------------------------------------------------
----------------------------------------------------------------------
----------------------------------------------------------------------
----------------------------------------------------------------------
----------------------------------------------------------------------
----------------------------------------------------------------------
----------------------------------------------------------------------
