GGGGGGGGGGGGGGGGGGGGGGGGGGGGGGGGGGGGGGGGGGGGGGGGGG--------------------
G----------------e------------------------G------G--------------------
G-----------------------------------------G------G--------------------
G-----------------------------------------G--G--MG--------------------
G--------------------------------------G--G--G---G--------------------
G----------------p-----------------NNN-G--G--G---G--------------------
G--------------------------------------G-----G---G--------------------
G--------------------------------------G-----GM--G--------------------
G---D----------------------------------G-----G---G--------------------
GGGGGGGGGGGGGGGGGGGGGGGGGGGGGM---------G-----G--MG--------------------
G---------------------c-----GM---------G-----G---G--------------------
G---------------------------GM------------N--GM--G--------------------
G--------------p------------GM---------G-----G---G--------------------
G----------G----------------GM---------G-----G--MG--------------------
G----------G----------------GGGGGGGGGGGG^^^^^G---G--------------------
G----S----------------------GGGGGGGGGGGGGGGGGGM--G--------------------
GGGGGG---------G--------G---Ge------^---^---^---MG--------------------
GGGGGG---------G--------G^--G-----^---^---^-----MG--------------------
GGGGGG---------G-------cG^--^---^GGGGGGGGGGGGGG-MG--------------------
GGGGGG---------G--------G^------^G--------------MG--------------------
GGGGGG---------G--------G^N-----^G--------------MG--------------------
GGGGGG---------G--------G^^^^^^^^G--GGGGGB--MGM-MG--------------------
GGGGGG-------GGG--------GGGGGGGGGG-----MG--BMGM-MG--------------------
GGGGGG-------^^G--------GGGGGGGGGGGGG--MG---MGM-MG--------------------
GGGGGG---------G^^^^^^^^Gl-----K------------MG-e-G--------------------
GGGGGGGGGGGGGGGGGGGGGGGGGGGGGGGGGGGGGGGGGGGGGGGGGG--------------------
GGGGGGGGGGGGGGGGGGGGGGGGGGGGGGGGGGGGGGGGGGGGGGGGGG--------------------
GGGGGGGGGGGGGGGGGGGGGGGGGGGGGGGGGGGGGGGGGGGGGGGGGG--------------------
----------------------------------------------------------------------
----------------------------------------------------------------------
----------------------------------------------------------------------
----------------------------------------------------------------------
----------------------------------------------------------------------
----------------------------------------------------------------------
----------------------------------------------------------------------
----------------------------------------------------------------------
----------------------------------------------------------------------
----------------------------------------------------------------------
----------------------------------------------------------------------
----------------------------------------------------------------------
----------------------------------------------------------------------
----------------------------------------------------------------------
----------------------------------------------------------------------
----------------------------------------------------------------------
----------------------------------------------------------------------
----------------------------------------------------------------------
----------------------------------------------------------------------
----------------------------------------------------------------------
----------------------------------------------------------------------
----------------------------------------------------------------------
----------------------------------------------------------------------
----------------------------------------------------------------------
----------------------------------------------------------------------
----------------------------------------------------------------------
----------------------------------------------------------------------
----------------------------------------------------------------------
----------------------------------------------------------------------
----------------------------------------------------------------------
----------------------------------------------------------------------
----------------------------------------------------------------------
----------------------------------------------------------------------
----------------------------------------------------------------------
----------------------------------------------------------------------
----------------------------------------------------------------------
----------------------------------------------------------------------
----------------------------------------------------------------------
----------------------------------------------------------------------
----------------------------------------------------------------------
----------------------------------------------------------------------
----------------------------------------------------------------------
