GGGGGGGGGGGGGGGGGGGGGGGGGGGGGGGGGGGGGGGGGGGGGGGGGG--------------------
G----------------e--------------------GG---------G--------------------
G-------------------------------------GG---------G--------------------
G-------------------------------------GG^-B--G--MG--------------------
G-------------------------------------GG^-B--G---G--------------------
G----------------p--------------------GG^----G---G--------------------
G-------------------------------------GG^----G---G--------------------
G-------------------------------------GG^----GM--G--------------------
G---D----e----------------------------GG^----G---G--------------------
GGGGGGGGGGGGGGGGGGGGGGGGGGGGGM--------GG^---BG---G--------------------
G---------------------------GM--------GG^---BG^--G--------------------
G---------------------------GM--------GG^----GM--G--------------------
G--------------p------------GM---------------G---G--------------------
G---------------------------GM--B---------i--G---G--------------------
G---------------------------GGGGGGGGGGGG^^G^^G---G--------------------
G----S---------G--------G---GGGGGGGGGGGGGGGGGGM--G--------------------
GGGGGG---------G--------G---Ge------------------MG--------------------
GGGGGG---------G--K-----G^--^-------------------MG--------------------
GGGGGG---------G--------G^------^GGGGGGGGGGGGGG-GG--------------------
GGGGGG---------G--------G^-------G------------G-GG--------------------
GGGGGG---------G--------G^------^G---^-----------G--------------------
GGGGGG---------G--------G^^^^^^^^G--GGGGGG--MGM--G--------------------
GGGGGG-------GGG--------GGGGGGGGGG---GG-GG-BMGM--G--------------------
GGGGGG-------^^G--------GGGGGGGGGGGG-----G--MGM--G--------------------
GGGGGG---------G^^^^^^^^Gl-----K-------^----MGLLLG--------------------
GGGGGGGGGGGGGGGGGGGGGGGGGGGGGGGGGGGGGGGGGGGGGGGGGG--------------------
GGGGGGGGGGGGGGGGGGGGGGGGGGGGGGGGGGGGGGGGGGGGGGGGGG--------------------
GGGGGGGGGGGGGGGGGGGGGGGGGGGGGGGGGGGGGGGGGGGGGGGGGG--------------------
----------------------------------------------------------------------
----------------------------------------------------------------------
----------------------------------------------------------------------
----------------------------------------------------------------------
----------------------------------------------------------------------
----------------------------------------------------------------------
----------------------------------------------------------------------
----------------------------------------------------------------------
----------------------------------------------------------------------
----------------------------------------------------------------------
----------------------------------------------------------------------
----------------------------------------------------------------------
----------------------------------------------------------------------
----------------------------------------------------------------------
----------------------------------------------------------------------
----------------------------------------------------------------------
----------------------------------------------------------------------
----------------------------------------------------------------------
----------------------------------------------------------------------
----------------------------------------------------------------------
----------------------------------------------------------------------
----------------------------------------------------------------------
----------------------------------------------------------------------
----------------------------------------------------------------------
----------------------------------------------------------------------
----------------------------------------------------------------------
----------------------------------------------------------------------
----------------------------------------------------------------------
----------------------------------------------------------------------
----------------------------------------------------------------------
----------------------------------------------------------------------
----------------------------------------------------------------------
----------------------------------------------------------------------
----------------------------------------------------------------------
----------------------------------------------------------------------
----------------------------------------------------------------------
----------------------------------------------------------------------
----------------------------------------------------------------------
----------------------------------------------------------------------
----------------------------------------------------------------------
----------------------------------------------------------------------
----------------------------------------------------------------------
