GGGGGGGGGGGGGGGGGGGGGGGGGGGGGGGGGGGGGGGGGGGGGGGGGG--------------------
G--------------------Gi-----N----G----GG---------G--------------------
G-----------------K--G--LLLLLGGG-G---cGG---------G--------------------
G-GGGGG--------------G--GGGGGG---G----GG^-B--G--MG--------------------
G----GG--------------G---G------MG----GG^-B--G---G--------------------
GGGG-GG-----------^------G------------GG^-B--G---G--------------------
G----GG------G^N-^G^-----G------------GG^----G---G--------------------
G-GGGGGLLLLLLGLLLLG^-NN-^G------------GG^----GM--G--------------------
G---DGGGGGGGGGGGGGGLLLLLLG------------GG^----G---G--------------------
GGGGGGGGGGGGGGGGGGGGGGGGGGGGGM--MG----GG^---BG---G--------------------
G---------------------------GM--------GG^---BG^--G--------------------
G--------------p------------GM--------GG^----GM--G--------------------
G---------------------------GM---------------G---G--------------------
G---------------------------GM--B---------i--G--MG--------------------
G---------------------------GGGGGGGGGGGG^^G^^G---G--------------------
G----S-------c-G--------G---GGGGGGGGGGGGGGGGGGM--G--------------------
GGGGGG---------G--------G---Ge------------------MG--------------------
GGGGGG---------G--K-----G^--G-------------------MG--------------------
GGGGGG---------G--------G^--^---^GGGGGGGGGGGGGG-GG--------------------
GGGGGG---------G--------G^------^G------------G-GG--------------------
GGGGGG---------G--------G^------^G---^-----------G--------------------
GGGGGG---------G--------G^^^^^^^^G--GGGGGG-BMGM--G--------------------
GGGGGG-------GGG--------GGGGGGGGGG---GG-GG-BMGM--G--------------------
GGGGGG-------^^G--------GGGGGGGGGGGG-----G--MGM--G--------------------
GGGGGG---------G^^^^^^^^Gl-----K-------^----MGLLLG--------------------
GGGGGGGGGGGGGGGGGGGGGGGGGGGGGGGGGGGGGGGGGGGGGGGGGG--------------------
GGGGGGGGGGGGGGGGGGGGGGGGGGGGGGGGGGGGGGGGGGGGGGGGGG--------------------
GGGGGGGGGGGGGGGGGGGGGGGGGGGGGGGGGGGGGGGGGGGGGGGGGG--------------------
----------------------------------------------------------------------
----------------------------------------------------------------------
----------------------------------------------------------------------
----------------------------------------------------------------------
----------------------------------------------------------------------
----------------------------------------------------------------------
----------------------------------------------------------------------
----------------------------------------------------------------------
----------------------------------------------------------------------
----------------------------------------------------------------------
----------------------------------------------------------------------
----------------------------------------------------------------------
----------------------------------------------------------------------
----------------------------------------------------------------------
----------------------------------------------------------------------
----------------------------------------------------------------------
----------------------------------------------------------------------
----------------------------------------------------------------------
----------------------------------------------------------------------
----------------------------------------------------------------------
----------------------------------------------------------------------
----------------------------------------------------------------------
----------------------------------------------------------------------
----------------------------------------------------------------------
----------------------------------------------------------------------
----------------------------------------------------------------------
----------------------------------------------------------------------
----------------------------------------------------------------------
----------------------------------------------------------------------
----------------------------------------------------------------------
----------------------------------------------------------------------
----------------------------------------------------------------------
----------------------------------------------------------------------
----------------------------------------------------------------------
----------------------------------------------------------------------
----------------------------------------------------------------------
----------------------------------------------------------------------
----------------------------------------------------------------------
----------------------------------------------------------------------
----------------------------------------------------------------------
----------------------------------------------------------------------
----------------------------------------------------------------------
