GGGGGGGGGGGGGGGGGGGGGGGGGGGGGGGGGGGGGGGGGGGGGGGGGG--------------------
G---------------------KG----------G-G----KG------G--------------------
G---------------------GG----------G-G-----G------G--------------------
G---------------------------------G----p--G--G--MG--------------------
G-------------G-------------------G-G-----G--G---G--------------------
G---------------------------------G-G-----G--G---G--------------------
G---------------------------------GMGGGGGGG--G---G--------------------
G---------------------------------GMG--------GM--G--------------------
GK--D-----GLLLLLGLLLLLG------------MG--------G---G--------------------
GGGGGGGGGGGGGGGGGGGGGGGGGGGGG------MG--------G---G--------------------
G---------------------------G------MG--------G^--G--------------------
G--------------p------------G---------------^GM--G--------------------
G---------------------------G----------^----GG---G--------------------
G---------------------------G---------^G^---eG--MG--------------------
G---------------------------GLLLLLLLGLLG^^K^^G---G--------------------
G----S---------G---B----G---GGGGGGGGGGGGGGGGGGM--G--------------------
GGGGGG---------G--------G---Ge------^---^---^---MG--------------------
GGGGGG---------G--K-----G^--^---------^---^-----MG--------------------
GGGGGG---------G--------G^------^GGGGGGGGGGGGGG-GG--------------------
GGGGGG---------G--------G^------^G------------G-GG--------------------
GGGGGG---------G--------G^------^G--^^-----------G--------------------
GGGGGG---------G--------G^^^^^^^^G--GGGGGG-BMG---G--------------------
GGGGGG------BGGG--------GGGGGGGGGG---GG-GG-BMG---G--------------------
GGGGGG-----^-^^G--------GGGGGGGGGGGG-G---G--MG---G--------------------
GGGGGG---------G^^^^^^^^Gl-K-----------^----MGLLLG--------------------
GGGGGGGGGGGGGGGGGGGGGGGGGGGGGGGGGGGGGGGGGGGGGGGGGG--------------------
GGGGGGGGGGGGGGGGGGGGGGGGGGGGGGGGGGGGGGGGGGGGGGGGGG--------------------
GGGGGGGGGGGGGGGGGGGGGGGGGGGGGGGGGGGGGGGGGGGGGGGGGG--------------------
----------------------------------------------------------------------
----------------------------------------------------------------------
----------------------------------------------------------------------
----------------------------------------------------------------------
----------------------------------------------------------------------
----------------------------------------------------------------------
----------------------------------------------------------------------
----------------------------------------------------------------------
----------------------------------------------------------------------
----------------------------------------------------------------------
----------------------------------------------------------------------
----------------------------------------------------------------------
----------------------------------------------------------------------
----------------------------------------------------------------------
----------------------------------------------------------------------
----------------------------------------------------------------------
----------------------------------------------------------------------
----------------------------------------------------------------------
----------------------------------------------------------------------
----------------------------------------------------------------------
----------------------------------------------------------------------
----------------------------------------------------------------------
----------------------------------------------------------------------
----------------------------------------------------------------------
----------------------------------------------------------------------
----------------------------------------------------------------------
----------------------------------------------------------------------
----------------------------------------------------------------------
----------------------------------------------------------------------
----------------------------------------------------------------------
----------------------------------------------------------------------
----------------------------------------------------------------------
----------------------------------------------------------------------
----------------------------------------------------------------------
----------------------------------------------------------------------
----------------------------------------------------------------------
----------------------------------------------------------------------
----------------------------------------------------------------------
----------------------------------------------------------------------
----------------------------------------------------------------------
----------------------------------------------------------------------
----------------------------------------------------------------------
