GGGGGGGGGGGGGGGGGGGGGGGGGGGGGGGGGGGGGGGGGGGGGGGGGG--------------------
G----e----------------KG----------G-G----KG------G--------------------
G---------------------GG----------G-G-----G------G--------------------
G---------------------------------G----p--G--G--MG--------------------
G-------------G-------------------G-G-----G--G---G--------------------
Ge--------------------------------G-G---B-G--G---G--------------------
G--D------------------------------GMGGGGGGG--G---G--------------------
GGGGG-----------------------------GMG--------GM--G--------------------
GK---B-----GLLLLGLLLLLG------------MG--------G---G--------------------
GGGGGGGGGGGGGGGGGGGGGGGGGGGGG------MG--B-----G---G--------------------
G---------------------------G------MG--------G^--G--------------------
G--------------p------------G---------------^GM--G--------------------
G---------------------------G----------^----GG---G--------------------
G---------------------------G---------^G^---eG--MG--------------------
G---------------------------GLLLLLLLGLLG^^K^^G---G--------------------
G----S---------G---B----G---GGGGGGGGGGGGGGGGGGM--G--------------------
GGGGGG---------G--------G---Ge------^---^---^---MG--------------------
GGGGGG---------G--K-----G^--^---------^---^-----MG--------------------
GGGGGG---------G--------G^------^GGGGGGGGGGGGGG-GG--------------------
GGGGGG---------G--------Gc------^G------------G-GG--------------------
GGGGGG---------G--------G^------^G--^^-----------G--------------------
GGGGGG---------G--------G^^^^^^^^G--GGGGGG-BMG---G--------------------
GGGGGG-------GGG-----B--GGGGGGGGGG---GGGGG-BMG---G--------------------
GGGGGG-------^^G--------GGGGGGGGGGGG-G---G--MG---G--------------------
GGGGGG---------G^^^^^^^^Gl-K-----------^----MGLLLG--------------------
GGGGGGGGGGGGGGGGGGGGGGGGGGGGGGGGGGGGGGGGGGGGGGGGGG--------------------
GGGGGGGGGGGGGGGGGGGGGGGGGGGGGGGGGGGGGGGGGGGGGGGGGG--------------------
GGGGGGGGGGGGGGGGGGGGGGGGGGGGGGGGGGGGGGGGGGGGGGGGGG--------------------
----------------------------------------------------------------------
----------------------------------------------------------------------
----------------------------------------------------------------------
----------------------------------------------------------------------
----------------------------------------------------------------------
----------------------------------------------------------------------
----------------------------------------------------------------------
----------------------------------------------------------------------
----------------------------------------------------------------------
----------------------------------------------------------------------
----------------------------------------------------------------------
----------------------------------------------------------------------
----------------------------------------------------------------------
----------------------------------------------------------------------
----------------------------------------------------------------------
----------------------------------------------------------------------
----------------------------------------------------------------------
----------------------------------------------------------------------
----------------------------------------------------------------------
----------------------------------------------------------------------
----------------------------------------------------------------------
----------------------------------------------------------------------
----------------------------------------------------------------------
----------------------------------------------------------------------
----------------------------------------------------------------------
----------------------------------------------------------------------
----------------------------------------------------------------------
----------------------------------------------------------------------
----------------------------------------------------------------------
----------------------------------------------------------------------
----------------------------------------------------------------------
----------------------------------------------------------------------
----------------------------------------------------------------------
----------------------------------------------------------------------
----------------------------------------------------------------------
----------------------------------------------------------------------
----------------------------------------------------------------------
----------------------------------------------------------------------
----------------------------------------------------------------------
----------------------------------------------------------------------
----------------------------------------------------------------------
----------------------------------------------------------------------
