GGGGGGGGGGGGGGGGGGGGGGGGGGGGGGGGGGGGGGGGGGGGGGGGGG--------------------
G----e-----------------KG---------G-G----KG------G--------------------
G---------------------GGG---------G-G-----G------G--------------------
G-----------------------G---------G----p--G--G--MG--------------------
G-------------G---------G---------G-G-----G--G--lG--------------------
Ge----------------------G---p-----G-G---B-G--G---G--------------------
G--D--------------------G---------GMGGGGGGG--Gl--G--------------------
GGGGGe----------------------------GMG--------GM--G--------------------
GK---B-----GLLLLGLLLLLG------------MG--------G---G--------------------
GGGGGGGGGGGGGGGGGGGGGGGGGGGGG------MG--B-----G---G--------------------
G---------------------------G------MG--------G^--G--------------------
G--------------p------------G---------------^GM--G--------------------
G---------------------------G----------^----GG---G--------------------
G---------------------------G---------^G^---eG--MG--------------------
G---------------------------GLLLLLLLGLLG^^K^^G---G--------------------
G----S-----B---G---B----G---GGGGGGGGGGGGGGGGGGM--G--------------------
GGGGGG---------G--------G---Ge------^---^---^---MG--------------------
GGGGGG---------G--K-----G^--^-----^---^---^-----MG--------------------
GGGGGG---------G--------G^------^GGGGGGGGGGGGGG-GG--------------------
GGGGGG---------G--------Gc------^G----------l-G-GG--------------------
GGGGGG---------G--------G^------^G--^^-----------G--------------------
GGGGGG---------G--------G^^^^^^^^G--GGGGGG-BMG---G--------------------
GGGGGG-------GGG-------cGGGGGGGGGG---GG-GG-BMG---G--------------------
GGGGGG-------^^G--------GGGGGG---GGG-G---G--MGLLLG--------------------
GGGGGG---------G^^^^^^^^Gl-K---^-------^----MGGGGG--------------------
GGGGGGGGGGGGGGGGGGGGGGGGGGGGGGGGGGGGGGGGGGGGGGGGGG--------------------
GGGGGGGGGGGGGGGGGGGGGGGGGGGGGGGGGGGGGGGGGGGGGGGGGG--------------------
GGGGGGGGGGGGGGGGGGGGGGGGGGGGGGGGGGGGGGGGGGGGGGGGGG--------------------
----------------------------------------------------------------------
----------------------------------------------------------------------
----------------------------------------------------------------------
----------------------------------------------------------------------
----------------------------------------------------------------------
----------------------------------------------------------------------
----------------------------------------------------------------------
----------------------------------------------------------------------
----------------------------------------------------------------------
----------------------------------------------------------------------
----------------------------------------------------------------------
----------------------------------------------------------------------
----------------------------------------------------------------------
----------------------------------------------------------------------
----------------------------------------------------------------------
----------------------------------------------------------------------
----------------------------------------------------------------------
----------------------------------------------------------------------
----------------------------------------------------------------------
----------------------------------------------------------------------
----------------------------------------------------------------------
----------------------------------------------------------------------
----------------------------------------------------------------------
----------------------------------------------------------------------
----------------------------------------------------------------------
----------------------------------------------------------------------
----------------------------------------------------------------------
----------------------------------------------------------------------
----------------------------------------------------------------------
----------------------------------------------------------------------
----------------------------------------------------------------------
----------------------------------------------------------------------
----------------------------------------------------------------------
----------------------------------------------------------------------
----------------------------------------------------------------------
----------------------------------------------------------------------
----------------------------------------------------------------------
----------------------------------------------------------------------
----------------------------------------------------------------------
----------------------------------------------------------------------
----------------------------------------------------------------------
----------------------------------------------------------------------
