GGGGGGGGGGGGGGGGGGGGGGGGGGGGGGGGGGGGGGGGGGGGGGGGGGG-------------------
GM-----G--------BG-------------------------------G--------------------
GM^GGG-G---------G-------------------------------G--------------------
GM^G--BG----G----G-------------------------------G--------------------
GM^G---G----G----G-------------------------------G--------------------
GMMG--------G----G-------------------------------G--------------------
G^MG--------G----G-------------------------------G--------------------
G^MGGGGGGGGGG----G-------------------------------G--------------------
G^-^G------------G-------------------------------G--------------------
GM-^G------------G-------------------------------G--------------------
GM-^G------------G-------------------------------G--------------------
GM-^G------------G-------------------------------G--------------------
G^MGG--GGGGGGGGGGG-------------------------------G--------------------
G^MGG--------------------------------------------G--------------------
G^MGG--------------------------------------------G--------------------
GM-^G--------------------------------------------G--------------------
GM-^G--------------------------------------------G--------------------
GM-^G--------------------------------------------G--------------------
G^-^G--------------------------------------------G--------------------
G^MGG--------------------------------------------G--------------------
G^MGG--------------------------------------------G--------------------
G-MGG--------------------------------------------G--------------------
G-SGG--------------------------------------------G--------------------
G--GG--------------------------------------------G--------------------
GGGGG--------------------------------------------G--------------------
GGGGGLLLLLLLLLLLLLLLLLLLLLLLLLLLLLLLLLLLLLLLLLLLLG--------------------
GGGGGGGGGGGGGGGGGGGGGGGGGGGGGGGGGGGGGGGGGGGGGGGGGG--------------------
GGGGGGGGGGGGGGGGGGGGGGGGGGGGGGGGGGGGGGGGGGGGGGGGGGG-------------------
GGGGGGGGGGGGGGGGGGGGGGGGGGGGGGGGGGGGGGGGGGGGGGGGGGG-------------------
----------------------------------------------------------------------
----------------------------------------------------------------------
----------------------------------------------------------------------
----------------------------------------------------------------------
----------------------------------------------------------------------
----------------------------------------------------------------------
----------------------------------------------------------------------
----------------------------------------------------------------------
----------------------------------------------------------------------
----------------------------------------------------------------------
----------------------------------------------------------------------
----------------------------------------------------------------------
----------------------------------------------------------------------
----------------------------------------------------------------------
----------------------------------------------------------------------
----------------------------------------------------------------------
----------------------------------------------------------------------
----------------------------------------------------------------------
----------------------------------------------------------------------
----------------------------------------------------------------------
----------------------------------------------------------------------
----------------------------------------------------------------------
----------------------------------------------------------------------
----------------------------------------------------------------------
----------------------------------------------------------------------
----------------------------------------------------------------------
----------------------------------------------------------------------
----------------------------------------------------------------------
----------------------------------------------------------------------
----------------------------------------------------------------------
----------------------------------------------------------------------
----------------------------------------------------------------------
----------------------------------------------------------------------
----------------------------------------------------------------------
----------------------------------------------------------------------
----------------------------------------------------------------------
----------------------------------------------------------------------
----------------------------------------------------------------------
----------------------------------------------------------------------
----------------------------------------------------------------------
----------------------------------------------------------------------
