GGGGGGGGGGGGGGGGGGGGGGGGGGGGGGGGGGGGGGGGGGGGGGGGGGG-------------------
GM-----G---------------G-------------------------G--------------------
GM-GGG-Gl--------------G-------------------------G--------------------
GM^G--BG----G----------G-------------------------G--------------------
GM^G---G----G----------G-------------------------G--------------------
GMMG--------G----------G-------------------------G--------------------
G^MG--------G---------cG-------------------------G--------------------
G^MGGGGGGGGGG----------G-------------------------G--------------------
G^-^G------------------G-------------------------G--------------------
GM-^G------------------G-------------------------G--------------------
GM-^G------------------G-------------------------G--------------------
GM-^G------------------G-------------------------G--------------------
G^MGG------------------G-------------------------G--------------------
G^MGG----GGGGGGGGGGGGGGG-------------------------G--------------------
G^MGG--------------------------------------------G--------------------
GM-^G--------------------------------------------G--------------------
GM-^G--------------------------------------------G--------------------
GM-^G--------------------------------------------G--------------------
G^-^G--------------------------------------------G--------------------
G^MGG--------------------------------------------G--------------------
G^MGG--------------------------------------------G--------------------
G-MGG--------------------------------------------G--------------------
G-SGG--------------------------------------------G--------------------
G--GG--------------------------------------------G--------------------
GGGGG--------------------------------------------G--------------------
GGGGGLLLLLLLLLLLLLLLLLLLLLLLLLLLLLLLLLLLLLLLLLLLLG--------------------
GGGGGGGGGGGGGGGGGGGGGGGGGGGGGGGGGGGGGGGGGGGGGGGGGG--------------------
GGGGGGGGGGGGGGGGGGGGGGGGGGGGGGGGGGGGGGGGGGGGGGGGGGG-------------------
GGGGGGGGGGGGGGGGGGGGGGGGGGGGGGGGGGGGGGGGGGGGGGGGGGG-------------------
----------------------------------------------------------------------
----------------------------------------------------------------------
----------------------------------------------------------------------
----------------------------------------------------------------------
----------------------------------------------------------------------
----------------------------------------------------------------------
----------------------------------------------------------------------
----------------------------------------------------------------------
----------------------------------------------------------------------
----------------------------------------------------------------------
----------------------------------------------------------------------
----------------------------------------------------------------------
----------------------------------------------------------------------
----------------------------------------------------------------------
----------------------------------------------------------------------
----------------------------------------------------------------------
----------------------------------------------------------------------
----------------------------------------------------------------------
----------------------------------------------------------------------
----------------------------------------------------------------------
----------------------------------------------------------------------
----------------------------------------------------------------------
----------------------------------------------------------------------
----------------------------------------------------------------------
----------------------------------------------------------------------
----------------------------------------------------------------------
----------------------------------------------------------------------
----------------------------------------------------------------------
----------------------------------------------------------------------
----------------------------------------------------------------------
----------------------------------------------------------------------
----------------------------------------------------------------------
----------------------------------------------------------------------
----------------------------------------------------------------------
----------------------------------------------------------------------
----------------------------------------------------------------------
----------------------------------------------------------------------
----------------------------------------------------------------------
----------------------------------------------------------------------
----------------------------------------------------------------------
----------------------------------------------------------------------
