GGGGGGGGGGGGGGGGGGGGGGGGGGGGGGGGGGGGGGGGGGGGGGGGGGG-------------------
GM-----G----------------G----------------------e-G--------------------
GM-GGG-Gl--------------lG--------------------GM--G--------------------
GM^G--BG----G--G--------G--------G--G--------G---G--------------------
GM^G---G----G--G--------G--------G--G--------G--MG--------------------
GMMG--------G--G--------G--------G--G--------G--MG--------------------
G^MG------B-G--G-------KG-----B--G--G-B------G---G--------------------
G^MGGGGGGGGGG--GGGGGGGGGGGGGGGGGGG--GGGGGGGGGG---G--------------------
G^-^G------------------eGc------------------cGM--G--------------------
GM-^G-------------------G--------------------GM--G--------------------
GM-^G-------------------G--------------------G---G--------------------
GM-^G-------------------G--------------------G---G--------------------
G^MGG-------------------G--------------------G--MG--------------------
G^MGG-------------------G--------------------G--MG--------------------
G^MGG-------------------G--------------------G---G--------------------
GM-^G-------------------G--------------------G---G--------------------
GM-^G-------------------G--------------------GM--G--------------------
GM-^G-------------------G--------------------GM--G--------------------
G^-^G-------------------G--------------------G---G--------------------
G^MGG-------------------G--------------------G---G--------------------
G^MGG-------------------GD-------------------G--MG--------------------
G-MGG-------------------GGGGGGGGGGGGGGGGGGGGGG--MG--------------------
G-SGG--------------------------------------------G--------------------
G--GG--------------------------------------------G--------------------
GGGGG^-----NNN---------^G^--NNN-----^G^---NNN----G--------------------
GGGGGLLLLLLLLLLLLLLLLLLLLLLLLLLLLLLLLLLLLLLLLLLLLG--------------------
GGGGGGGGGGGGGGGGGGGGGGGGGGGGGGGGGGGGGGGGGGGGGGGGGG--------------------
GGGGGGGGGGGGGGGGGGGGGGGGGGGGGGGGGGGGGGGGGGGGGGGGGGG-------------------
GGGGGGGGGGGGGGGGGGGGGGGGGGGGGGGGGGGGGGGGGGGGGGGGGGG-------------------
----------------------------------------------------------------------
----------------------------------------------------------------------
----------------------------------------------------------------------
----------------------------------------------------------------------
----------------------------------------------------------------------
----------------------------------------------------------------------
----------------------------------------------------------------------
----------------------------------------------------------------------
----------------------------------------------------------------------
----------------------------------------------------------------------
----------------------------------------------------------------------
----------------------------------------------------------------------
----------------------------------------------------------------------
----------------------------------------------------------------------
----------------------------------------------------------------------
----------------------------------------------------------------------
----------------------------------------------------------------------
----------------------------------------------------------------------
----------------------------------------------------------------------
----------------------------------------------------------------------
----------------------------------------------------------------------
----------------------------------------------------------------------
----------------------------------------------------------------------
----------------------------------------------------------------------
----------------------------------------------------------------------
----------------------------------------------------------------------
----------------------------------------------------------------------
----------------------------------------------------------------------
----------------------------------------------------------------------
----------------------------------------------------------------------
----------------------------------------------------------------------
----------------------------------------------------------------------
----------------------------------------------------------------------
----------------------------------------------------------------------
----------------------------------------------------------------------
----------------------------------------------------------------------
----------------------------------------------------------------------
----------------------------------------------------------------------
----------------------------------------------------------------------
----------------------------------------------------------------------
----------------------------------------------------------------------
