GGGGGGGGGGGGGGGGGGGGGGGGGGGGGGGGGGGGGGGGGGGGGGGGGGG-------------------
GM-----G---------------lG----------------------e-G--------------------
GM-GGG-Gl---------------G--------------------GM--G--------------------
GM^G--BG----G--G--------G-------------------MG---G--------------------
GM^G---G----G--G--------GK------------------MG^-MG--------------------
GMMG--------G--G--------G^N---------i-------MG^-MG--------------------
G^MG------B-G--GB------KGLLLLLLLLLLL--LLLLL--G---G--------------------
G^MGGGGGGGGGG--GGGGGGGGGGGGGGGGGGGGGGGGGGGG--G---G--------------------
G^-^G------------------eG-----------------G--GM-^G--------------------
GM-^G-------------------Gc----------------GM-GM-^G--------------------
GM-^G------------------lG--------------------G---G--------------------
GM-^Gl------------------G--------------------G---G--------------------
G^MGG------------------lG-----------^-^-^-^--G^-MG--------------------
G^MGGl------------------G-----------GGGGGGGGGG^-MG--------------------
G^MGG------------------lG--------------------G---G--------------------
GM-^Gl------------------G--------------------G---G--------------------
GM-^G------------------lG--------------------GM-^G--------------------
GM-^Gl------------------G--------------------GM-^G--------------------
G^-^G------------------lG--------------------G---G--------------------
G^MGG-------------------G--------------------G---G--------------------
G^MGG-------------------G-------------------DG^-MG--------------------
G-MGG-------------------GGGGGGGGGGGGGGGGGGGGGG^-MG--------------------
G-SGG--------------------------------------------G--------------------
G--GG-------------------------------------^------G--------------------
GGGGG^-----NNN---------^G^--NNN----------^G^---NNG--------------------
GGGGGLLLLLLLLLLLLLLLLLLLLLLLLLLLLLLLLLLLLLLLLLLLLG--------------------
GGGGGGGGGGGGGGGGGGGGGGGGGGGGGGGGGGGGGGGGGGGGGGGGGG--------------------
GGGGGGGGGGGGGGGGGGGGGGGGGGGGGGGGGGGGGGGGGGGGGGGGGGG-------------------
GGGGGGGGGGGGGGGGGGGGGGGGGGGGGGGGGGGGGGGGGGGGGGGGGGG-------------------
----------------------------------------------------------------------
----------------------------------------------------------------------
----------------------------------------------------------------------
----------------------------------------------------------------------
----------------------------------------------------------------------
----------------------------------------------------------------------
----------------------------------------------------------------------
----------------------------------------------------------------------
----------------------------------------------------------------------
----------------------------------------------------------------------
----------------------------------------------------------------------
----------------------------------------------------------------------
----------------------------------------------------------------------
----------------------------------------------------------------------
----------------------------------------------------------------------
----------------------------------------------------------------------
----------------------------------------------------------------------
----------------------------------------------------------------------
----------------------------------------------------------------------
----------------------------------------------------------------------
----------------------------------------------------------------------
----------------------------------------------------------------------
----------------------------------------------------------------------
----------------------------------------------------------------------
----------------------------------------------------------------------
----------------------------------------------------------------------
----------------------------------------------------------------------
----------------------------------------------------------------------
----------------------------------------------------------------------
----------------------------------------------------------------------
----------------------------------------------------------------------
----------------------------------------------------------------------
----------------------------------------------------------------------
----------------------------------------------------------------------
----------------------------------------------------------------------
----------------------------------------------------------------------
----------------------------------------------------------------------
----------------------------------------------------------------------
----------------------------------------------------------------------
----------------------------------------------------------------------
----------------------------------------------------------------------
