GGGGGGGGGGGGGGGGGGGGGGGGGGGGGGGGGGGGGGGGGGGGGGGGGGG-------------------
GM-----G---------------G-------------------------G--------------------
GM-GGG-Gl-------------lG-------------------------G--------------------
GM^G--BG----G----------G-------------------------G--------------------
GM^G---G----G----------G-------------------------G--------------------
GMMG--------G----------G-------------------------G--------------------
G^MG--------G----------G-------------------------G--------------------
G^MGGGGGGGGGG----------G-------------------------G--------------------
G^-^G------------------G-------------------------G--------------------
GM-^G------------------G-------------------------G--------------------
GM-^G------------------G-------------------------G--------------------
GM-^G------------------G-------------------------G--------------------
G^MGG------------------G-------------------------G--------------------
G^MGG--GGGGGGGGGGGGGGGGG-------------------------G--------------------
G^MGG--------c---------G-------------------------G--------------------
GM-^G------------------G-------------------------G--------------------
GM-^G------------------G-------------------------G--------------------
GM-^G------------------G-------------------------G--------------------
G^-^G------------------G-------------------------G--------------------
G^MGG------------------G-------------------------G--------------------
G^MGG--------K---------G-------------------------G--------------------
G-MGG------------------G-------------------------G--------------------
G-SGG----------------D-G-------------------------G--------------------
G--GG^-N------------^GGG-------------------------G--------------------
GGGGG--------------------------------------------G--------------------
GGGGGLLLLLLLLLLLLLLLLLLLLLLLLLLLLLLLLLLLLLLLLLLLLG--------------------
GGGGGGGGGGGGGGGGGGGGGGGGGGGGGGGGGGGGGGGGGGGGGGGGGG--------------------
GGGGGGGGGGGGGGGGGGGGGGGGGGGGGGGGGGGGGGGGGGGGGGGGGGG-------------------
GGGGGGGGGGGGGGGGGGGGGGGGGGGGGGGGGGGGGGGGGGGGGGGGGGG-------------------
----------------------------------------------------------------------
----------------------------------------------------------------------
----------------------------------------------------------------------
----------------------------------------------------------------------
----------------------------------------------------------------------
----------------------------------------------------------------------
----------------------------------------------------------------------
----------------------------------------------------------------------
----------------------------------------------------------------------
----------------------------------------------------------------------
----------------------------------------------------------------------
----------------------------------------------------------------------
----------------------------------------------------------------------
----------------------------------------------------------------------
----------------------------------------------------------------------
----------------------------------------------------------------------
----------------------------------------------------------------------
----------------------------------------------------------------------
----------------------------------------------------------------------
----------------------------------------------------------------------
----------------------------------------------------------------------
----------------------------------------------------------------------
----------------------------------------------------------------------
----------------------------------------------------------------------
----------------------------------------------------------------------
----------------------------------------------------------------------
----------------------------------------------------------------------
----------------------------------------------------------------------
----------------------------------------------------------------------
----------------------------------------------------------------------
----------------------------------------------------------------------
----------------------------------------------------------------------
----------------------------------------------------------------------
----------------------------------------------------------------------
----------------------------------------------------------------------
----------------------------------------------------------------------
----------------------------------------------------------------------
----------------------------------------------------------------------
----------------------------------------------------------------------
----------------------------------------------------------------------
----------------------------------------------------------------------
