GGGGGGGGGGGGGGGGGGGGGGGGGGGGGGGGGGGGGGGGGGGGGGGGGGG-------------------
GM-----G----------------G----------------------e-G--------------------
GM^GGG-Gl--------------lG--------------------GM--G--------------------
GM^G--BG----G--G--------G--------------------G---G--------------------
GM^G---G----G--G--------GK-------------------G^-MG--------------------
GMMG--------G--G--------G^N---------i--------G^-MG--------------------
G^MG------B-G--GB------KGLLLLLLLLLLL--LLLLL--G---G--------------------
G^MGGGGGGGGGG--GGGGGGGGGGGGGGGGGGGGGGGGGGGG--G---G--------------------
G^-^G------------------eGc-------------------GM-^G--------------------
GM-^G-------------------G--------------------GM-^G--------------------
GM-^G------------------lG--------------------G---G--------------------
GM-^G------------------lG--------------------G---G--------------------
G^MGG------------------lG--------------------G^-MG--------------------
G^MGG------------------lG--------------------G^-MG--------------------
G^MGG------------------lG--------------------G---G--------------------
GM-^G------------------lG--------------------G---G--------------------
GM-^G------------------lG--------------------GM-^G--------------------
GM-^G------------------lG--------------------GM-^G--------------------
G^-^G------------------lG--------------------G---G--------------------
G^MGG-------------------G--------------------G---G--------------------
G^MGGK-----------------KGD-------------------G^-MG--------------------
G-MGGG-----------------GGGGGGGGGGGGGGGGGGGGGGG^-MG--------------------
G-SGG--------------------------------------------G--------------------
G--GG--------------------------------^-----------G--------------------
GGGGG^-----NNN---------^G^--NNN-----^G^---NNN----G--------------------
GGGGGLLLLLLLLLLLLLLLLLLLLLLLLLLLLLLLLLLLLLLLLLLLLG--------------------
GGGGGGGGGGGGGGGGGGGGGGGGGGGGGGGGGGGGGGGGGGGGGGGGGG--------------------
GGGGGGGGGGGGGGGGGGGGGGGGGGGGGGGGGGGGGGGGGGGGGGGGGGG-------------------
GGGGGGGGGGGGGGGGGGGGGGGGGGGGGGGGGGGGGGGGGGGGGGGGGGG-------------------
----------------------------------------------------------------------
----------------------------------------------------------------------
----------------------------------------------------------------------
----------------------------------------------------------------------
----------------------------------------------------------------------
----------------------------------------------------------------------
----------------------------------------------------------------------
----------------------------------------------------------------------
----------------------------------------------------------------------
----------------------------------------------------------------------
----------------------------------------------------------------------
----------------------------------------------------------------------
----------------------------------------------------------------------
----------------------------------------------------------------------
----------------------------------------------------------------------
----------------------------------------------------------------------
----------------------------------------------------------------------
----------------------------------------------------------------------
----------------------------------------------------------------------
----------------------------------------------------------------------
----------------------------------------------------------------------
----------------------------------------------------------------------
----------------------------------------------------------------------
----------------------------------------------------------------------
----------------------------------------------------------------------
----------------------------------------------------------------------
----------------------------------------------------------------------
----------------------------------------------------------------------
----------------------------------------------------------------------
----------------------------------------------------------------------
----------------------------------------------------------------------
----------------------------------------------------------------------
----------------------------------------------------------------------
----------------------------------------------------------------------
----------------------------------------------------------------------
----------------------------------------------------------------------
----------------------------------------------------------------------
----------------------------------------------------------------------
----------------------------------------------------------------------
----------------------------------------------------------------------
----------------------------------------------------------------------
