GGGGGGGGGGGGGGGGGGGGGGGGGGGGGGGGGGGGGGGGGGGGGGGGGGG-------------------
GM-----G---------------lG----------------------e-G--------------------
GM-GG--Gl---------------G--------------------GM--G--------------------
GM^G---G----GMMG--------G--------------------G---G--------------------
GM^G--GG----GMMG--------GK----G-------------MG^-MG--------------------
GMMGM-------GMMG--------G^N---^-----i-------MG^-MG--------------------
G^MG------B-GMMGB------KGLLLLLLLLLLL--LLLLL--G---G--------------------
G^MGGGGGGGGGGMMGGGGGGGGGGGGGGGGGGGGGGGGGGGG--G---G--------------------
G^-^Gl------------------G-----------------G--GM-^G--------------------
GM-^G--------G----------Gc----------------GM-GM-^G--------------------
GM-^Gl------------------G--------------------G---G--------------------
GM-^G-------------------G--------------------G---G--------------------
G^MGG--------------G----G-----------^-^-^-^--G^-MG--------------------
G^MGGl------------------G---BB---GM-GGGGGGGGGG^-MG--------------------
G^MGG-------------------G--------GM----------G---G--------------------
GM-^G-----------G-------G--------GM----------G--KG--------------------
GM-^Gl------------------G--------GM----------GGGGG--------------------
GM-^G-------------------G--------GM----BB--------G--------------------
G^-^G--------G----------G--------GGGGGGGGGGGGG---G--------------------
G^MGGl------------------G--------------------G---G--------------------
G^MGG-------------------Ge------------------DG^-MG--------------------
G-MGG-----G-------------GGGGGGGGGGGGGGGGGGGGGG^-MG--------------------
G--G---------------------------------------------G--------------------
G-^GS-------------------G-----------^G^----------G--------------------
G-^GG^-----NNN---------^G^--NNN-----^G^-------NNNG--------------------
GK-GGLLLLLLLLLLLLLLLLLLLLLLLLLLLLLLLLLLLLLLLLLLLLG--------------------
GGGGGGGGGGGGGGGGGGGGGGGGGGGGGGGGGGGGGGGGGGGGGGGGGG--------------------
GGGGGGGGGGGGGGGGGGGGGGGGGGGGGGGGGGGGGGGGGGGGGGGGGGG-------------------
GGGGGGGGGGGGGGGGGGGGGGGGGGGGGGGGGGGGGGGGGGGGGGGGGGG-------------------
----------------------------------------------------------------------
----------------------------------------------------------------------
----------------------------------------------------------------------
----------------------------------------------------------------------
----------------------------------------------------------------------
----------------------------------------------------------------------
----------------------------------------------------------------------
----------------------------------------------------------------------
----------------------------------------------------------------------
----------------------------------------------------------------------
----------------------------------------------------------------------
----------------------------------------------------------------------
----------------------------------------------------------------------
----------------------------------------------------------------------
----------------------------------------------------------------------
----------------------------------------------------------------------
----------------------------------------------------------------------
----------------------------------------------------------------------
----------------------------------------------------------------------
----------------------------------------------------------------------
----------------------------------------------------------------------
----------------------------------------------------------------------
----------------------------------------------------------------------
----------------------------------------------------------------------
----------------------------------------------------------------------
----------------------------------------------------------------------
----------------------------------------------------------------------
----------------------------------------------------------------------
----------------------------------------------------------------------
----------------------------------------------------------------------
----------------------------------------------------------------------
----------------------------------------------------------------------
----------------------------------------------------------------------
----------------------------------------------------------------------
----------------------------------------------------------------------
----------------------------------------------------------------------
----------------------------------------------------------------------
----------------------------------------------------------------------
----------------------------------------------------------------------
----------------------------------------------------------------------
----------------------------------------------------------------------
