GGGGGGGGGGGGGGGGGGGGGGGGGGGGGGGGGGGGGGGGGGGGGGGGGGG-------------------
GM-----G----------------G----------------------e-G--------------------
GM^GG--Gl--------------lG-----^--------------GM--G--------------------
GM^G---G----GMMGB-------G-----G--------------G---G--------------------
GM^G---G----GMMG--------GK----G-------------MG^-MG--------------------
GMMGM-------GMMG--------G^N---^-----i-------MG^-MG--------------------
G^MG------B-GMMG------BKGLLLLLLLLLLL--LLLLL--G---G--------------------
G^MGGGGGGGGGGMMGGGGGGGGGGGGGGGGGGGGGGGGGGGG--G---G--------------------
G^-^Gl-----------------lG-----------------G--GM-^G--------------------
GM-^Ge-------G----------Gc----------------GM-GM-^G--------------------
GM-^Gl-----------------lG--------------------G---G--------------------
GM-^G--------------G----G--------------------G---G--------------------
G^MGG-------------------Gl----------^-^-^-^-^G^-MG--------------------
G^MGGl-----------------lG---BB---G^-GGGGGGGGGG^-MG--------------------
G^MGG-------------------G--------G-----------G---G--------------------
GM-^G-----------G-------G--------GM----------G--KG--------------------
GM-^Gl-----------------lG---BB---GM----------GGGGG--------------------
GM-^G-------------------G--------GM--^-^-^-^-----G--------------------
G^-^G--------G----------G--------GGGGGGGGGGGGG---G--------------------
G^MGGl-----------------lG--------^---^---^---G---G--------------------
G^MGG-------------------Ge---------^---^---^DG^-MG--------------------
G-MGG-----G-------------GGGGGGGGGGGGGGGGGGGGGG^-MG--------------------
G-^G---------------------------------------------G--------------------
G-^GS-------------------G-----------^G^----------G--------------------
G-^GG^-----NNN---------^G^--NNN-----^G^---NNN----G--------------------
GK-GGLLLLLLLLLLLLLLLLLLLLLLLLLLLLLLLLLLLLLLLLLLLLG--------------------
GGGGGGGGGGGGGGGGGGGGGGGGGGGGGGGGGGGGGGGGGGGGGGGGGG--------------------
GGGGGGGGGGGGGGGGGGGGGGGGGGGGGGGGGGGGGGGGGGGGGGGGGGG-------------------
GGGGGGGGGGGGGGGGGGGGGGGGGGGGGGGGGGGGGGGGGGGGGGGGGGG-------------------
----------------------------------------------------------------------
----------------------------------------------------------------------
----------------------------------------------------------------------
----------------------------------------------------------------------
----------------------------------------------------------------------
----------------------------------------------------------------------
----------------------------------------------------------------------
----------------------------------------------------------------------
----------------------------------------------------------------------
----------------------------------------------------------------------
----------------------------------------------------------------------
----------------------------------------------------------------------
----------------------------------------------------------------------
----------------------------------------------------------------------
----------------------------------------------------------------------
----------------------------------------------------------------------
----------------------------------------------------------------------
----------------------------------------------------------------------
----------------------------------------------------------------------
----------------------------------------------------------------------
----------------------------------------------------------------------
----------------------------------------------------------------------
----------------------------------------------------------------------
----------------------------------------------------------------------
----------------------------------------------------------------------
----------------------------------------------------------------------
----------------------------------------------------------------------
----------------------------------------------------------------------
----------------------------------------------------------------------
----------------------------------------------------------------------
----------------------------------------------------------------------
----------------------------------------------------------------------
----------------------------------------------------------------------
----------------------------------------------------------------------
----------------------------------------------------------------------
----------------------------------------------------------------------
----------------------------------------------------------------------
----------------------------------------------------------------------
----------------------------------------------------------------------
----------------------------------------------------------------------
----------------------------------------------------------------------
