GGGGGGGGGGGGGGGGGGGGGGGGGGGGGGGGGGGGGGGGGGGGGGGGGGG-------------------
GM-----G-------G-------------------------------GKG--------------------
GM-GG--Gl------G-----------------------------G-G-G--------------------
GM^G---G----G--G-----^-------^-------^-------G-G-G--------------------
GM^G---Gl---G--G----^G^-----^G^-----^G^-----MG-GMG--------------------
GM^G--------G--G-i---^-------^-------^--NNi-MG-G-G--------------------
GM^GB------BG--GDGLLLLLLLLLLLLLLLLLLLLLLLLG--G-G-G--------------------
G^^GGGGGGGGGG--GGGGGGGGGGGGGGGGGGGGGGGGGGGG--G-G-G--------------------
GM-^G--e------------e--------e------------G--G-GMG--------------------
GM-lG-------------------------------------GM-G-G-G--------------------
GM--G----------------------------------------G-G-G--------------------
GM-^G---------------------------G------------G-G-G--------------------
GM-GG--------------------------MGG--^-^-^-^--G-GMG--------------------
G^-GG----------------------------G--GGGGGGGGGG---G--------------------
GM-^G---------p------------------G-----------G---G--------------------
GM-lG----------------------------GM----------G---G--------------------
GM--G----------------------------GM----------G---G--------------------
GM-^G----GG-------GG-------GG----GM--------------G--------------------
GM-GG-----G-------G--------G-----GGGGGGGGGGGGG---G--------------------
G^-GG----------------------------^---^---^---G---G--------------------
GM^GGK-----------------------------^---^---^KG^-MG--------------------
GM^GGGGGGGGGGGGGGGGGGGGGGGGGGGGGGGGGGGGGGGGGGG^-MG--------------------
GM-G---------------------------------------------G--------------------
GM-GK-----G-------------G------------G----------^G--------------------
G--GG^----^NNN---------^G^--NNN-----^G^NNN------^G--------------------
GS-GGLLLLLLLLLLLLLLLLLLLLLLLLLLLLLLLLLLLLLLLLLLLLG--------------------
GGGGGGGGGGGGGGGGGGGGGGGGGGGGGGGGGGGGGGGGGGGGGGGGGG--------------------
GGGGGGGGGGGGGGGGGGGGGGGGGGGGGGGGGGGGGGGGGGGGGGGGGGG-------------------
GGGGGGGGGGGGGGGGGGGGGGGGGGGGGGGGGGGGGGGGGGGGGGGGGGG-------------------
----------------------------------------------------------------------
----------------------------------------------------------------------
----------------------------------------------------------------------
----------------------------------------------------------------------
----------------------------------------------------------------------
----------------------------------------------------------------------
----------------------------------------------------------------------
----------------------------------------------------------------------
----------------------------------------------------------------------
----------------------------------------------------------------------
----------------------------------------------------------------------
----------------------------------------------------------------------
----------------------------------------------------------------------
----------------------------------------------------------------------
----------------------------------------------------------------------
----------------------------------------------------------------------
----------------------------------------------------------------------
----------------------------------------------------------------------
----------------------------------------------------------------------
----------------------------------------------------------------------
----------------------------------------------------------------------
----------------------------------------------------------------------
----------------------------------------------------------------------
----------------------------------------------------------------------
----------------------------------------------------------------------
----------------------------------------------------------------------
----------------------------------------------------------------------
----------------------------------------------------------------------
----------------------------------------------------------------------
----------------------------------------------------------------------
----------------------------------------------------------------------
----------------------------------------------------------------------
----------------------------------------------------------------------
----------------------------------------------------------------------
----------------------------------------------------------------------
----------------------------------------------------------------------
----------------------------------------------------------------------
----------------------------------------------------------------------
----------------------------------------------------------------------
----------------------------------------------------------------------
----------------------------------------------------------------------
