GGGGGGGGGGGGGGGGGGGGGGGGGGGGGGGGGGGGGGGGGGGGGGGGGGG-------------------
GM------G------G-------------------------------GKG--------------------
GM-GG---G---G--G-----------------------------G-G-G--------------------
GM^G--------G--G-----^---^---^---^---^-------G-G-G--------------------
GM^G--------G--G----^G^-^G^-^G^-^G^-^G^-----MG-GMG--------------------
GM^G--------G--G-----^---^---^---^---^---N--MG-G-G--------------------
G^^G^^^^^^^^G--GDGLLLLLLLLLLLLLLLLLLLLLLLLG--G-G-G--------------------
G^^GGGGGGGGGG--GGGGGGGGGGGGGGGGGGGGGGGGGGGG--G-G-G--------------------
GM-^G--e------------e--------e------------G--G-GMG--------------------
GM-lG-------------------------------------GM-G-G-G--------------------
GM-lG----------------------------------------G-G-G--------------------
GM-^G----------------------------------------G-G-G--------------------
G^^GG---------------------------MG--^-^-^-^-^G-GMG--------------------
G^^GG----------------------------G--GGGGGGGGGG---G--------------------
GM-^G---------p------------------G-----------G---G--------------------
GM-lG----------------------------GM----------G-^^G--------------------
GM-lG----------------------------GM----------G-GGG--------------------
GM-^G----GG-------GG------GG-----GM--------------G--------------------
G^-GG-----G-------G-------G------GGGGGGGGGGGGG---G--------------------
G^-GG----------------------------^---^---^---G---G--------------------
GM^GGK------B----------------------^---^---^-G^-MG--------------------
GM^GGGGGGGGGGGGGGGGGGGGGGGGGGGGGGGGGGGGGGGGGGG^-MG--------------------
GM-G---------------------------------------------G--------------------
GM-GK-----G------G-----^G^----------^G^---------^G--------------------
G--GG^----^NN----^-----^G^--NN------^G^NN-------^G--------------------
GS-GGLLLLLLLLLLLLLLLLLLLLLLLLLLLLLLLLLLLLLLLLLLLLG--------------------
GGGGGGGGGGGGGGGGGGGGGGGGGGGGGGGGGGGGGGGGGGGGGGGGGG--------------------
GGGGGGGGGGGGGGGGGGGGGGGGGGGGGGGGGGGGGGGGGGGGGGGGGGG-------------------
GGGGGGGGGGGGGGGGGGGGGGGGGGGGGGGGGGGGGGGGGGGGGGGGGGG-------------------
----------------------------------------------------------------------
----------------------------------------------------------------------
----------------------------------------------------------------------
----------------------------------------------------------------------
----------------------------------------------------------------------
----------------------------------------------------------------------
----------------------------------------------------------------------
----------------------------------------------------------------------
----------------------------------------------------------------------
----------------------------------------------------------------------
----------------------------------------------------------------------
----------------------------------------------------------------------
----------------------------------------------------------------------
----------------------------------------------------------------------
----------------------------------------------------------------------
----------------------------------------------------------------------
----------------------------------------------------------------------
----------------------------------------------------------------------
----------------------------------------------------------------------
----------------------------------------------------------------------
----------------------------------------------------------------------
----------------------------------------------------------------------
----------------------------------------------------------------------
----------------------------------------------------------------------
----------------------------------------------------------------------
----------------------------------------------------------------------
----------------------------------------------------------------------
----------------------------------------------------------------------
----------------------------------------------------------------------
----------------------------------------------------------------------
----------------------------------------------------------------------
----------------------------------------------------------------------
----------------------------------------------------------------------
----------------------------------------------------------------------
----------------------------------------------------------------------
----------------------------------------------------------------------
----------------------------------------------------------------------
----------------------------------------------------------------------
----------------------------------------------------------------------
----------------------------------------------------------------------
----------------------------------------------------------------------
