GGGGGGGGGGGGGGGGGGGGGGGGGGGGGGGGGGGGGGGGGGGGGGGGGGG-------------------
G-l-----G------G-----e---e---e---e---e---e-------G--------------------
G-^GG---G---G^^G^--------------------------------G--------------------
G-^G--------G^^G^----------------------------G---G--------------------
G-^G--------G^^G^----------K-----------------G---G--------------------
G-^GK-------G^^G^-G--------------------------G---G--------------------
GG-G^^^^^^^^G^^G--G--------------------------G---G--------------------
G^-GGGGGGGGGG^^G-GGGGGGGGGGGGGGGGGGGGGGGGGGGGGB--G--------------------
G^--G^^^^^^^^-^G-^^^^^^^^^^^^^^^^^^^^^^G-----G---G--------------------
G---G^--------^G---------------^------^G-----G---G--------------------
GG-^G^--------^G^-----NNN-----^G^-NN--^G--p--G---G--------------------
Gl-^G^-NN-----^G^-------------^G^-----MG-----G---G--------------------
G--^G^---------^--------------^G^-----MGK----G---G--------------------
G---G^-------------^-----------^-------GGGGG-G---G--------------------
G^-GG^------------^G^------------------------G--BG--------------------
G^-lG^K---^-------^G^-----^^^^---------^-----G---G--------------------
G^--G^NN-^G^--NN--^G^-NN-^GGGG^-NNN---^G^NN--G---G--------------------
G---G^----^--------^------^^^^---------^-----G---G--------------------
GG-^G^---------------------------------------G---G--------------------
Gl-^G^^^^^^^^^^^^^^^^^^^^^^^^^^^^^^^^^^^^^^^^G---G--------------------
G--^GGGGGGGGGGGGGGGGGGGGGGGGGGGGGGGGGGGGGGGGGG---G--------------------
G---GGG---GGGGG---GGGGG---GGGGG---GGGGG---GGGG---G--------------------
G--GG---^-------^-------^-------^-------^--------G--------------------
G---G---G------BG------BG------BG------BG------BGG--------------------
G---G---G------BG------BG------BG------BG------BGG--------------------
GSl-GD--G-------G-------G-------G-------G-------GG--------------------
GGGGGGGGGGGGGGGGGGGGGGGGGGGGGGGGGGGGGGGGGGGGGGGGGG--------------------
GGGGGGGGGGGGGGGGGGGGGGGGGGGGGGGGGGGGGGGGGGGGGGGGGGG-------------------
GGGGGGGGGGGGGGGGGGGGGGGGGGGGGGGGGGGGGGGGGGGGGGGGGGG-------------------
----------------------------------------------------------------------
----------------------------------------------------------------------
----------------------------------------------------------------------
----------------------------------------------------------------------
----------------------------------------------------------------------
----------------------------------------------------------------------
----------------------------------------------------------------------
----------------------------------------------------------------------
----------------------------------------------------------------------
----------------------------------------------------------------------
----------------------------------------------------------------------
----------------------------------------------------------------------
----------------------------------------------------------------------
----------------------------------------------------------------------
----------------------------------------------------------------------
----------------------------------------------------------------------
----------------------------------------------------------------------
----------------------------------------------------------------------
----------------------------------------------------------------------
----------------------------------------------------------------------
----------------------------------------------------------------------
----------------------------------------------------------------------
----------------------------------------------------------------------
----------------------------------------------------------------------
----------------------------------------------------------------------
----------------------------------------------------------------------
----------------------------------------------------------------------
----------------------------------------------------------------------
----------------------------------------------------------------------
----------------------------------------------------------------------
----------------------------------------------------------------------
----------------------------------------------------------------------
----------------------------------------------------------------------
----------------------------------------------------------------------
----------------------------------------------------------------------
----------------------------------------------------------------------
----------------------------------------------------------------------
----------------------------------------------------------------------
----------------------------------------------------------------------
----------------------------------------------------------------------
----------------------------------------------------------------------
