GGGGGGGGGGGGGGGGGGGGGGGGGGGGGGGGGGGGGGGGGGGGGGGGGGG-------------------
G------MGM---------------------------------------G--------------------
GS-----MGM--B-----------B------i-----------------G--------------------
G------MGM--B-----B-----B-----BG-----------------G--------------------
GGGGGM-MGM--------B-----------BG-----------------G--------------------
GMKMGM-MGM---------------------G-----------------G--------------------
GM-MGM-MGM-MGGGGGGGGGGGGGGGGGGGG-----------------G--------------------
GM-MGM-MG--MGGGGGGGGGGGGGGGGGGGG-----------------G--------------------
G--MGM-MG--MGGGGGGGGGGGGGGGGGGGG-----------------G--------------------
G--MGM-MG--MGGGGGGGGGGGGGGGGGGGG-----------------G--------------------
G--MGM-MG--MGGGGGGGGGGGGGGGGGGGG-----------------G--------------------
G--MGM-MGM------------------GGGG-----------------G--------------------
GM--GM-MGM------------------GGGG-----------------G--------------------
GM--GM-MGM------------------GGGGGGGGGGG----------G--------------------
GM--GM-MGM------------------GGGGGGGGGGG----------G--------------------
GM--GM-MGM-----------------KGGGGGGGGGGG----------G--------------------
GM--GM-MG--MGGGGGGGGGGGGGGGGGGGG-----------------G--------------------
G--MGM-MG--MGGGGGGGGGGGGGGGGGGGG-----------------G--------------------
G--MGM-MG--MGGGGGGGGGGGGGGGGGGGG-----------------G--------------------
G--MGM-MG--MGGGGGGGGGGGGGGGGGGGG-------GGGGGGGGGGG--------------------
G--MGM-MG-------------------GGGG-----------------G--------------------
GM-MGM-MG-------------------GGGG-----------------G--------------------
GM-----MGGGGGGGGGGGGGG------GGGGGGGGGG-----------G--------------------
GM--------------------------GGGG-----------------G--------------------
GM--------------------------GGGG-----------------G--------------------
GM--------------------------GGGG-D---------------G--------------------
GGGGGGGGGGGGGGGGGGGGGGGGGGGGGGGGGGGGGGGGGGGGGGGGGGG-------------------
GGGGGGGGGGGGGGGGGGGGGGGGGGGGGGGGGGGGGGGGGGGGGGGGGGG-------------------
GGGGGGGGGGGGGGGGGGGGGGGGGGGGGGGGGGGGGGGGGGGGGGGGGGG-------------------
----------------------------------------------------------------------
----------------------------------------------------------------------
----------------------------------------------------------------------
----------------------------------------------------------------------
----------------------------------------------------------------------
----------------------------------------------------------------------
----------------------------------------------------------------------
----------------------------------------------------------------------
----------------------------------------------------------------------
----------------------------------------------------------------------
----------------------------------------------------------------------
----------------------------------------------------------------------
----------------------------------------------------------------------
----------------------------------------------------------------------
----------------------------------------------------------------------
----------------------------------------------------------------------
----------------------------------------------------------------------
----------------------------------------------------------------------
----------------------------------------------------------------------
----------------------------------------------------------------------
----------------------------------------------------------------------
----------------------------------------------------------------------
----------------------------------------------------------------------
----------------------------------------------------------------------
----------------------------------------------------------------------
----------------------------------------------------------------------
----------------------------------------------------------------------
----------------------------------------------------------------------
----------------------------------------------------------------------
----------------------------------------------------------------------
----------------------------------------------------------------------
----------------------------------------------------------------------
----------------------------------------------------------------------
----------------------------------------------------------------------
----------------------------------------------------------------------
----------------------------------------------------------------------
----------------------------------------------------------------------
----------------------------------------------------------------------
----------------------------------------------------------------------
----------------------------------------------------------------------
----------------------------------------------------------------------
