GGGGGGGGGGGGGGGGGGGGGGGGGGGGGGGGGGGGGGGGGGGGGGGGGGG
G------MGM--B-----B--B-----B---------------------G
GS-----MGM--B--B--B--B--B--B--B------------------G
G------MGM--B--B--B--B--B--B--B------------------G
GGGGGM-MGM--B--B--B--B--B--B--B------------------G
GMKMGM-MGM-----B--------B-----B------------------G
GM-MGM-MGM-MGGGGGGGGGGGGGGGGGGGG-----------------G
GM-MGM-MG--MGGGGGGGGGGGGGGGGGGGG-----------------G
G--MGM-MG--MGGGGGGGGGGGGGGGGGGGG-----------------G
G--MGM-MG--MGGGGGGGGGGGGGGGGGGGG-----------------G
G--MGM-MG--MGGGGGGGGGGGGGGGGGGGG-----------------G
G--MGM-MGM------------------GGGG-----------------G
GM--GM-MGM------------------GGGG-----------------G
GM--GM-MGM------------------GGGGGGGGGGG----------G
GM--GM-MGM------------------GGGGGGGGGGG----------G
GM--GM-MGM-----------------KGGGGGGGGGGG----------G
GM--GM-MG--MGGGGGGGGGGGGGGGGGGGG-----------------G
G--MGM-MG--MGGGGGGGGGGGGGGGGGGGG-----------------G
G--MGM-MG--MGGGGGGGGGGGGGGGGGGGG-----------------G
G--MGM-MG--MGGGGGGGGGGGGGGGGGGGG--------GGGGGGGGGG
G--MGM-MG-------------------GGGG-----------------G
GM-MGM-MG-------------------GGGG-----------------G
GM-----MGGGGGGGGGGGGGG------GGGGGGGGGG-----------G
GM--------------------------GGGG-----------------G
GM--------------------------GGGG-----------------G
GM--------------------------GGGG-D---------------G
GGGGGGGGGGGGGGGGGGGGGGGGGGGGGGGGGGGGGGGGGGGGGGGGGGG
GGGGGGGGGGGGGGGGGGGGGGGGGGGGGGGGGGGGGGGGGGGGGGGGGGG
GGGGGGGGGGGGGGGGGGGGGGGGGGGGGGGGGGGGGGGGGGGGGGGGGGG