GGGGGGGGGGGGGGGGGGGGGGGGGGGGGGGGGGGGGGGGGGGGGGGGGGG-------------------
G------------------------------------------------G--------------------
G------------------------------------------------G--------------------
GM-----------------------------------------------G--------------------
GM-GGGGG-----------------------------------------G--------------------
GM-GGGGGiNN--i-------iNN--i----------------------G--------------------
GM-MGGGG-------iNN--i----------------------------G--------------------
G--MGGGG-----------------------------------------G--------------------
G--MG-MG-----------------------------------------G--------------------
G--MGKMG-----------------------------------------G--------------------
GM--G-MG---------------------------------------D-G--------------------
GM----MG---------------------iNN-----iGGGGGGGGGGGG--------------------
G-----lGLLLLLLLLLLLLLLLLLLLLLLLLLLLLLLG----------G--------------------
G--MG--GGGGGGGGGGGGGGGGGGGGGGGGGGGGGGGG----------G--------------------
G--MG--------------------------------------------G--------------------
GM-MG--------------------------------------------G--------------------
GM-----------------------------------------------G--------------------
GM-----------------------------------------------G--------------------
G------------------------------------------------G--------------------
GGGGGGGGGG---------------------------------------G--------------------
G------------------------------------------------G--------------------
G---------i-NN--i--------------------------------G--------------------
G---------------i-NN--i-iNN--i-------------------G--------------------
G------------------------------------------------G--------------------
G-S--------------------------GG------------------G--------------------
G----------------------------GGiN----iiNN----i--KG--------------------
GGGGGGGGGGGGGGGGGGGGGGGGGGGGGGGLLLLLLLLLLLLLLGGGGG--------------------
GGGGGGGGGGGGGGGGGGGGGGGGGGGGGGGGGGGGGGGGGGGGGGGGGGG-------------------
GGGGGGGGGGGGGGGGGGGGGGGGGGGGGGGGGGGGGGGGGGGGGGGGGGG-------------------