GGGGGGGGGGGGGGGGGGGGGGGGGGGGGGGGGGGGGGGGGGGGGGGGGGG-------------------
GM-----G----------------G----------------------e-G--------------------
GM^GG--Gl--------------lG-----^--------------GM--G--------------------
GM^G---G----GMMGB-------G-----G--------------G---G--------------------
GM^G---G----GMMG--------GK----G-------------MG^-MG--------------------
GMMGM-------GMMG--------G^N---^-----i-------MG^-MG--------------------
G^MG------B-GMMG------BKGLLLLLLLLLLL--LLLLL--G---G--------------------
G^MGGGGGGGGGGMMGGGGGGGGGGGGGGGGGGGGGGGGGGGG--G---G--------------------
G^-^Gl------------------G-----------------G--GM-^G--------------------
GM-^Ge-------G---------lGc----------------GM-GM-^G--------------------
GM-^Gl------------------G--------------------G---G--------------------
GM-^Gl-------------G----G--------------------G---G--------------------
G^MGG------------------lG-----------^-^-^-^--G^-MG--------------------
G^MGGl------------------G---BB---G^-GGGGGGGGGG^-MG--------------------
G^MGG------------------lG--------G-----------G---G--------------------
GM-^G-----------G-------G--------GM----------Gl-KG--------------------
GM-^Gl------------------G---BB---GM----------GGGGG--------------------
GM-^G------------------lG--------GM----BB--------G--------------------
G^-^G--------G----------G--------GGGGGGGGGGGGG---G--------------------
G^MGGl------------------G--------^---^---^---G---G--------------------
G^MGG-------------------Ge---------^---^---^DG^-MG--------------------
G-MGG-----G-------------GGGGGGGGGGGGGGGGGGGGGG^-MG--------------------
G--G---------------------------------------------G--------------------
G-^GS------------------^G^----------^G^----------G--------------------
G-^GG^-----NNN---------^G^--NNN-----^G^NNN------^G--------------------
GK-GGLLLLLLLLLLLLLLLLLLLLLLLLLLLLLLLLLLLLLLLLLLLLG--------------------
GGGGGGGGGGGGGGGGGGGGGGGGGGGGGGGGGGGGGGGGGGGGGGGGGG--------------------
GGGGGGGGGGGGGGGGGGGGGGGGGGGGGGGGGGGGGGGGGGGGGGGGGGG-------------------
GGGGGGGGGGGGGGGGGGGGGGGGGGGGGGGGGGGGGGGGGGGGGGGGGGG-------------------
----------------------------------------------------------------------
----------------------------------------------------------------------
----------------------------------------------------------------------
----------------------------------------------------------------------
----------------------------------------------------------------------
----------------------------------------------------------------------
----------------------------------------------------------------------
----------------------------------------------------------------------
----------------------------------------------------------------------
----------------------------------------------------------------------
----------------------------------------------------------------------
----------------------------------------------------------------------
----------------------------------------------------------------------
----------------------------------------------------------------------
----------------------------------------------------------------------
----------------------------------------------------------------------
----------------------------------------------------------------------
----------------------------------------------------------------------
----------------------------------------------------------------------
----------------------------------------------------------------------
----------------------------------------------------------------------
----------------------------------------------------------------------
----------------------------------------------------------------------
----------------------------------------------------------------------
----------------------------------------------------------------------
----------------------------------------------------------------------
----------------------------------------------------------------------
----------------------------------------------------------------------
----------------------------------------------------------------------
----------------------------------------------------------------------
----------------------------------------------------------------------
----------------------------------------------------------------------
----------------------------------------------------------------------
----------------------------------------------------------------------
----------------------------------------------------------------------
----------------------------------------------------------------------
----------------------------------------------------------------------
----------------------------------------------------------------------
----------------------------------------------------------------------
----------------------------------------------------------------------
----------------------------------------------------------------------
