GGGGGGGGGGGGGGGGGGGGGGGGGGGGGGGGGGGGGGGGGGGGGGGGGGG-------------------
GM------G------G-------------------------------GKG--------------------
GM-GG---G---G--G-----------------------------G-G-G--------------------
GM-G--------G--G-----^---^---^---^---^-------G-G-G--------------------
G^-G--------G--G----^G^-^G^-^G^-^G^-^G^-----MG-GMG--------------------
GM-G--------G--G-----^---^---^---^---^---N--MG-G-G--------------------
GM-G^^^^^^^^G--GDGLLLLLLLLLLLLLLLLLLLLLLLLG--G-G-G--------------------
GM-GGGGGGGGGG--GGGGGGGGGGGGGGGGGGGGGGGGGGGG--G-G-G--------------------
G^-^G--e------------e--------e------------G--G-GMG--------------------
GM-^G-------------------------------------GM-G-G-G--------------------
GM-^G----------------------------------------G-G-G--------------------
GM-^G---------------------------G------------G-G-G--------------------
G^-GG--------------------------MG---^-^-^-^--G-GMG--------------------
GM-GG---------------------------GG--GGGGGGGGGG---G--------------------
GM-^G---------p------------------GM----------G---G--------------------
GM-^G----------------------------G-----------G-^^G--------------------
G^-^G----------------------------G-------------GGG--------------------
GM-^G----GG-------GG------GG-----GGGGGGGGGGGGG---G--------------------
GM^GG-----G-------G-------G------^-^-^-^-^---G---G--------------------
GM^GG---------------------------------------KG--MG--------------------
GMMGGK-------------B-------------------------G^-MG--------------------
G^MGGGGGGGGGGGGGGGGGGGGGGGGGGGGGGGGGGGGGGGGGGG^-MG--------------------
G-MG---------------------------------------------G--------------------
G--G------G------G-----^G^----------^G^---------^G--------------------
G--GK-----^NN----^-----^G^--NN------^G^NN-------^G--------------------
GS-GGLLLLLLLLLLLLLLLLLLLLLLLLLLLLLLLLLLLLLLLLLLLLG--------------------
GGGGGGGGGGGGGGGGGGGGGGGGGGGGGGGGGGGGGGGGGGGGGGGGGG--------------------
GGGGGGGGGGGGGGGGGGGGGGGGGGGGGGGGGGGGGGGGGGGGGGGGGGG-------------------
GGGGGGGGGGGGGGGGGGGGGGGGGGGGGGGGGGGGGGGGGGGGGGGGGGG-------------------
----------------------------------------------------------------------
----------------------------------------------------------------------
----------------------------------------------------------------------
----------------------------------------------------------------------
----------------------------------------------------------------------
----------------------------------------------------------------------
----------------------------------------------------------------------
----------------------------------------------------------------------
----------------------------------------------------------------------
----------------------------------------------------------------------
----------------------------------------------------------------------
----------------------------------------------------------------------
----------------------------------------------------------------------
----------------------------------------------------------------------
----------------------------------------------------------------------
----------------------------------------------------------------------
----------------------------------------------------------------------
----------------------------------------------------------------------
----------------------------------------------------------------------
----------------------------------------------------------------------
----------------------------------------------------------------------
----------------------------------------------------------------------
----------------------------------------------------------------------
----------------------------------------------------------------------
----------------------------------------------------------------------
----------------------------------------------------------------------
----------------------------------------------------------------------
----------------------------------------------------------------------
----------------------------------------------------------------------
----------------------------------------------------------------------
----------------------------------------------------------------------
----------------------------------------------------------------------
----------------------------------------------------------------------
----------------------------------------------------------------------
----------------------------------------------------------------------
----------------------------------------------------------------------
----------------------------------------------------------------------
----------------------------------------------------------------------
----------------------------------------------------------------------
----------------------------------------------------------------------
----------------------------------------------------------------------
