GGGGGGGGGGGGGGGGGGGGGGGGGGGGGGGGGGGGGGGGGGGGGGGGGGG-------------------
G-------G------G-----e---e---e---e---e-----G-----G--------------------
G--GG---G-----^G^--------------------------G-----G--------------------
G-^G--------G^^G^----------------------------G---G--------------------
G-^G--------G^^G^----------K-----------------G---G--------------------
G--GK-------G^^G^-G-----------------------GGGG---G--------------------
GG-G^^^^^^^^G^^G--G-----------------------GB-----G--------------------
G^-GGGGGGGGGG^^G-GGGGGGGGGGGGGGGGGGGGGGGGGG------G--------------------
G^--G^^^^^^^^-^G-^^^^^^^^^^^^^^^^^^^^^^GGGGGGG---G--------------------
G---G^--------^G-----------------------G-----G---G--------------------
GG-^G^--------^G^-----NNN--------------G--p--G---G--------------------
Gl-^G^-NN-----^G^---------^G---G^NN----G-----G---G--------------------
G--^G^---------^----------^GGGGG^-----MGK----G---G--------------------
G---G^-----------------^G^------------MGGGGG-G---G--------------------
G^-GG^-------------^----^--------------------G---G--------------------
G^-lG^K---^-------^G^-----^^^----------^-----G---G--------------------
G^--G^NN-^G^--NN--^G^-NN-^GGG^--NNN---^G^NN--G---G--------------------
G---G^----^--------^------^^^----------^--^^^G---G--------------------
GG-^G^-----------------------------------^GGGG---G--------------------
Gl-^G^^^^^^^^^^^^^^^^^^^^^^^^^^^^^^^^^^^^^G-----BG--------------------
G--^GGGGGGGGGGGGGGGGGGGGGGGGGGGGGGGGGGGGGGG------G--------------------
G---GGG---GGGGG---GGGGG---GGGGG---GGGGG---GGGGG--G--------------------
G--GG---^-------^-------^-------^-------^--------G--------------------
G---G---G------BG------BG------BG------BG------BGG--------------------
G---G---G------BG------BG------BG------BG------BGG--------------------
GSl-GD--G-------G-------G-------G-------G-------GG--------------------
GGGGGGGGGGGGGGGGGGGGGGGGGGGGGGGGGGGGGGGGGGGGGGGGGG--------------------
GGGGGGGGGGGGGGGGGGGGGGGGGGGGGGGGGGGGGGGGGGGGGGGGGGG-------------------
GGGGGGGGGGGGGGGGGGGGGGGGGGGGGGGGGGGGGGGGGGGGGGGGGGG-------------------
----------------------------------------------------------------------
----------------------------------------------------------------------
----------------------------------------------------------------------
----------------------------------------------------------------------
----------------------------------------------------------------------
----------------------------------------------------------------------
----------------------------------------------------------------------
----------------------------------------------------------------------
----------------------------------------------------------------------
----------------------------------------------------------------------
----------------------------------------------------------------------
----------------------------------------------------------------------
----------------------------------------------------------------------
----------------------------------------------------------------------
----------------------------------------------------------------------
----------------------------------------------------------------------
----------------------------------------------------------------------
----------------------------------------------------------------------
----------------------------------------------------------------------
----------------------------------------------------------------------
----------------------------------------------------------------------
----------------------------------------------------------------------
----------------------------------------------------------------------
----------------------------------------------------------------------
----------------------------------------------------------------------
----------------------------------------------------------------------
----------------------------------------------------------------------
----------------------------------------------------------------------
----------------------------------------------------------------------
----------------------------------------------------------------------
----------------------------------------------------------------------
----------------------------------------------------------------------
----------------------------------------------------------------------
----------------------------------------------------------------------
----------------------------------------------------------------------
----------------------------------------------------------------------
----------------------------------------------------------------------
----------------------------------------------------------------------
----------------------------------------------------------------------
----------------------------------------------------------------------
----------------------------------------------------------------------
