GGGGGGGGGGGGGGGGGGGGGGGGGGGGGGGGGGGGGGGGGGGGGGGGGGG-------------------
G-------G------G-----e---e---e---e---e---e-G-----G--------------------
G-^GG---Ge----^G^--------------------------G-----G--------------------
G-^G--------G^^G^----------------------------G---G--------------------
G-^G--------G^^G^-^--------K-----------------G---G--------------------
G--GK-------G^^G^-G-----------------------GGGGM-lG--------------------
GG-G^^^^^^^^G^^G--GD----------BB----------GB-----G--------------------
G^-GGGGGGGGGG^^G-GGGGGGGGGGGGGGGGGGGGGGGGGG------G--------------------
G^--G^^^^^^^^-^G-^^^^^^^^^^^^^^^^^^^^^^GGGGGGG---G--------------------
G---G^--------^G-----------------------G-----Gl-MG--------------------
GG-^G^--------^G^-----NNN--------------G--p--G---G--------------------
Gl-^G^--------^G^---------^G-^-G^NN----G-----G---G--------------------
G--^G^---------^----------^GGGGG^-----MGK----G---G--------------------
G---G^-------------^------------------MGGGGG-GM-lG--------------------
G^-GG^------------^G^------------------------G---G--------------------
G^-lG^K---^-------^G^-----^^^----------^-----G---G--------------------
G^--G^NN-^G^--NN--^G^-NN-^GGG^--NNN---^G^NN--G---G--------------------
G---G^----^--------^------^^^----------^--^^^Gl-MG--------------------
GG-^G^-----------------------------------^GGGG--MG--------------------
Gl-^G^^^^^^^^^^^^^^^^^^^^^^^^^^^^^^^^^^^^^G-----BG--------------------
G--^GGGGGGGGGGGGGGGGGGGGGGGGGGGGGGGGGGGGGGG------G--------------------
G---GGG---GGGGG---GGGGG---GGGGG---GGGGG---GGGGG--G--------------------
G--GG-----------^-------^-------^-------^--------G--------------------
G---G---G------BG------BG------BG------BG------BGG--------------------
G---G---G------BG------BG------BG------BG------BGG--------------------
GSl-GK--G-------G-------G-------G-------G-------GG--------------------
GGGGGGGGGGGGGGGGGGGGGGGGGGGGGGGGGGGGGGGGGGGGGGGGGG--------------------
GGGGGGGGGGGGGGGGGGGGGGGGGGGGGGGGGGGGGGGGGGGGGGGGGGG-------------------
GGGGGGGGGGGGGGGGGGGGGGGGGGGGGGGGGGGGGGGGGGGGGGGGGGG-------------------
----------------------------------------------------------------------
----------------------------------------------------------------------
----------------------------------------------------------------------
----------------------------------------------------------------------
----------------------------------------------------------------------
----------------------------------------------------------------------
----------------------------------------------------------------------
----------------------------------------------------------------------
----------------------------------------------------------------------
----------------------------------------------------------------------
----------------------------------------------------------------------
----------------------------------------------------------------------
----------------------------------------------------------------------
----------------------------------------------------------------------
----------------------------------------------------------------------
----------------------------------------------------------------------
----------------------------------------------------------------------
----------------------------------------------------------------------
----------------------------------------------------------------------
----------------------------------------------------------------------
----------------------------------------------------------------------
----------------------------------------------------------------------
----------------------------------------------------------------------
----------------------------------------------------------------------
----------------------------------------------------------------------
----------------------------------------------------------------------
----------------------------------------------------------------------
----------------------------------------------------------------------
----------------------------------------------------------------------
----------------------------------------------------------------------
----------------------------------------------------------------------
----------------------------------------------------------------------
----------------------------------------------------------------------
----------------------------------------------------------------------
----------------------------------------------------------------------
----------------------------------------------------------------------
----------------------------------------------------------------------
----------------------------------------------------------------------
----------------------------------------------------------------------
----------------------------------------------------------------------
----------------------------------------------------------------------
