GGGGGGGGGGGGGGGGGGGGGGGGGGGGGGGGGGGGGGGGGGGGGGGGGGGGGGGGGGGGGG
G----------------------------------------------------------G
G----------------------------------------------------------G
G----------------------------------------------------------G
G----------------------------------------------------------G
G----------------------------------------------------------G
G----------------------------------------------------------G
G-----------------------t----------------------------------G
G----------------------------------------------------------G
G----------------------------------------------------------G
G----------------------------------------------------------G
G----------------------------------------------------------G
G----------------------------------------------------------G
G----------------------------------------------------------G
G----------------------------------------------------------G
G----------------------------------------------------------G
G----------------------------------------------------------G
G------------------------------------t---------------------G
G----------------Q-----------------------------------------G
G-------------GGGG-----------------------------------------G
G--------------c-------------------------------------------G
G----------------------------------------------------------G
G----------------------------------------------------------G
G----G-----------------------------------------------------G
G----G---------------------------------------------------- G
G----G-------cGcGcGc-------------t-------------------------G
G----G----G--cGcGcGc---------------------------------------G
G---------G--cGcGcGc---------------------------------------G
G---------G--cGcGcGc---------------------------------------G
G-----S---G--cGcGcGc---------------------------------------G
G------------cGcGcGc-----^^^^--B--^^^^--B--^^^^--------D---G
GGGGGGGGGGGGGGGGGGGGGGGGGGGGGGGGGGGGGGGGGGGGGGGGGGGGGGGGGGGGGG
GGGGGGGGGGGGGGGGGGGGGGGGGGGGGGGGGGGGGGGGGGGGGGGGGGGGGGGGGGGGGG
GGGGGGGGGGGGGGGGGGGGGGGGGGGGGGGGGGGGGGGGGGGGGGGGGGGGGGGGGGGGGG