GGGGGGGGGGGGGGGGGGGGGGGGGGGGGGGGGGGGGGGGGGGGGGGGGG--------------------
﻿GGGGGGGGGGGGGGGGGGGGGGGGGGGGGGGGGGGGGGGGGGGGGGGGG---------------------
G------------------------------------------------G--------------------
G------------------------------------------------G--------------------
G------------------------------------------------G--------------------
G------------------------------------------------G--------------------
G------------------------------------------------G--------------------
G------------------------------------------------G--------------------
G------------------------------------------------G--------------------
G------------------------------------------------G--------------------
G------------------------------------------------G--------------------
G------------------------------------------------G--------------------
G------------------------------------------------G--------------------
G------------------------------------------------G--------------------
G------------------------------------------------G--------------------
G------------------------------------------------G--------------------
G------------------------------------------------G--------------------
G------------------------------------------------G--------------------
G------------------------------------------------G--------------------
G------------------------------------------------G--------------------
G------------------------------------------------G--------------------
G------------------------------------------------G--------------------
G------------------------------------------------G--------------------
G------------------------------------------------G--------------------
G-------------K----------------------------------G--------------------
G-S----------------------------------------------G--------------------
G------------^^------K------------------------D--G--------------------
G------------^^-------------------------------D--G--------------------
GGGGGGGGGGGGGGGGGGGGGGGGGGGGGGGGGGGGGGGGGGGGGGGGGG--------------------
GGGGGGGGGGGGGGGGGGGGGGGGGGGGGGGGGGGGGGGGGGGGGGGGGG--------------------
GGGGGGGGGGGGGGGGGGGGGGGGGGGGGGGGGGGGGGGGGGGGGGGGGG--------------------
----------------------------------------------------------------------
----------------------------------------------------------------------
----------------------------------------------------------------------
----------------------------------------------------------------------
----------------------------------------------------------------------
----------------------------------------------------------------------
----------------------------------------------------------------------
----------------------------------------------------------------------
----------------------------------------------------------------------
----------------------------------------------------------------------
----------------------------------------------------------------------
----------------------------------------------------------------------
----------------------------------------------------------------------
----------------------------------------------------------------------
----------------------------------------------------------------------
----------------------------------------------------------------------
----------------------------------------------------------------------
----------------------------------------------------------------------
----------------------------------------------------------------------
----------------------------------------------------------------------
----------------------------------------------------------------------
----------------------------------------------------------------------
----------------------------------------------------------------------
----------------------------------------------------------------------
----------------------------------------------------------------------
----------------------------------------------------------------------
----------------------------------------------------------------------
----------------------------------------------------------------------
----------------------------------------------------------------------
----------------------------------------------------------------------
----------------------------------------------------------------------
----------------------------------------------------------------------
----------------------------------------------------------------------
----------------------------------------------------------------------
----------------------------------------------------------------------
----------------------------------------------------------------------
----------------------------------------------------------------------
----------------------------------------------------------------------
----------------------------------------------------------------------
----------------------------------------------------------------------
----------------------------------------------------------------------
