GGGGGGGGGGGGGGGGGGGGGGGGGGGGGGGGGGGGGGGGGGGGGGGGGGGGGGGGGGGGGG
G----------------------------------------------------------G
G----------------------------------------------------------G
G----------------------------------------------------------G
G----------------------------------------------------------G
G----------------------------------------------------------G
G----------------------------------------------------------G
G----------------------------------------------------------G
G----------------------------------------------------------G
G----------------------------------------------------------G
G----------------------------------------------------------G
G----------------------------------------------------------G
G----------------------------------------------------------G
G----------------------------------------------------------G
G----------------------------------------------------------G
G----------------------------------------------------------G
G----------------------------------------------------------G
G----------------------------------------------------------G
G----------------------------------------------------------G
G-------------GGGG-----------------------------------------G
G--------------c-------------------------------------------G
G----------------------------------------------------------G
G----------------------------------------------------------G
G----------------------------------------------------------G
G--------------c-------------------------------------------G
G-------------GGGGc----------------------------------------G
G-------------GGGG-----------------------------------------G
G------------cGGGG-----------------------------------------G
G-------------GGGG-----------------------------------------G
G-----S-------GGGG-----------------------------------------G
G-------------GGGG----B--^^^^--B--^^^^--B--^^^^--------D---G
GGGGGGGGGGGGGGGGGGGGGGGGGGGGGGGGGGGGGGGGGGGGGGGGGGGGGGGGGGGGGG
GGGGGGGGGGGGGGGGGGGGGGGGGGGGGGGGGGGGGGGGGGGGGGGGGGGGGGGGGGGGGG
GGGGGGGGGGGGGGGGGGGGGGGGGGGGGGGGGGGGGGGGGGGGGGGGGGGGGGGGGGGGGG