GGGGGGGGGGGGGGGGGGGGGGGGGGGGGGGGGGGGGGGGGGGGGGGGGGGGGGGGGGGGGG
G----------------------------------------------------------G
G----------------------------------------------------------G
G-----------cGcGcGcGcGcGcGcGcGcGcGcGcGcGcGcGcGcGcG---------G
G-----------cGcGcGcGcGcGcGcGcGcGcGcGcGcGcGcGcGcGcG---------G
G-----------cGcGcGcGcGcGcGcGcGcGcGcGcGcGcGcGcGcGcG---------G
G-----------cGcGcGcGcGcGcGcGcGcGcGcGcGcGcGcGcGcGcG---------G
G-----------cGcGcGcGcGcGcGcGcGcGcGcGcGcGcGcGcGcGcG---------G
G-----------cGcGcGcGcGcGcGcGcGcGcGcGcGcGcGcGcGcGcG---------G
G-----------cGcGcGcGcGcGcGcGcGcGcGcGcGcGcGcGcGcGcG---------G
G-----------cGcGcGcGcGcGcGcGcGcGcGcGcGcGcGcGcGcGcG---------G
G-----------cGcGcGcGcGcGcGcGcGcGcGcGcGcGcGcGcGcGcG---------G
G-----------cGcGcGcGcGcGcGcGcGcGcGcGcGcGcGcGcGcGcG---------G
G-----------cGcGcGcGcGcGcGcGcGcGcGcGcGcGcGcGcGcGcG---------G
G-----------cGcGcGcGcGcGcGcGcGcGcGcGcGcGcGcGcGcGcG---------G
G-----------cGcGcGcGcGcGcGcGcGcGcGcGcGcGcGcGcGcGcG---------G
G-----------cGcGcGcGcGcGcGcGcGcGcGcGcGcGcGcGcGcGcG---------G
G-----------cGcGcGcGcGcGcGcGcGcGcGcGcGcGcGcGcGcGcG---------G
G----------------------------------------------------------G
G-------------GGGG-----------------------------------------G
G--------------c-------------------------------------------G
G----------------------------------------------------------G
G----------------------------------------------------------G
G----------------------------------------------------------G
G--------------c-------------------------------------------G
G------------cGGGGc----------------------------------------G
G---------G--cGGGGc----------------------------------------G
G---------G--cGGGGc----------------------------------------G
G---------G--cGGGGc----------------------------------------G
G-----S---G--cGGGGc----------------------------------------G
G------------cGGGGc---B--^^^^--B--^^^^--B--^^^^--------D---G
GGGGGGGGGGGGGGGGGGGGGGGGGGGGGGGGGGGGGGGGGGGGGGGGGGGGGGGGGGGGGG
GGGGGGGGGGGGGGGGGGGGGGGGGGGGGGGGGGGGGGGGGGGGGGGGGGGGGGGGGGGGGG
GGGGGGGGGGGGGGGGGGGGGGGGGGGGGGGGGGGGGGGGGGGGGGGGGGGGGGGGGGGGGG