GGGGGGGGGGGGGGGGGGGGGGGGGGGGGGGGGGGGGGGGGGGGGGGGGG
G------------------------------------------------G
G------------------------------------------------G
G------------------------------------------------G
G------------------------------------------------G
G------------------------------------------------G
G------------------------------------------------G
G------------------------------------------------G
G------------------------------------------------G
G------------------------------------------------G
G------------------------------------------------G
G------------------------------------------------G
G------------------------------------------------G
G-------------GGGG-------------------------------G
G--------------c---------------------------------G
G------------------------------------------------G
G------------------------------------------------G
G--------------c---------------------------------G
G-------------GGGG-------------------------------G
G-------------GGGG-------------------------------G
G------------cGGGGc------------------------------G
G-------------GGGG-------------------------------G
G-------------GGGG-------------------------------G
G-------------GGGG-------------------------------G
G-----S-------GGGG-------------------------------G
G-B------c----GGGG-----D------^^^^^^^^^----------G
GGGGGGGGGGGGGGGGGGGGGGGGGGGGGGGGGGGGGGGGGGGGGGGGGG
GGGGGGGGGGGGGGGGGGDGGGGGGGGGGGGGGGGGGGGGGGGGGGGGGG
GGGGGGGGGGGGGGGGGGGGGGGGGGGGGGGGGGGGGGGGGGGGGGGGGG
GGGGGGGGGGGGGGGGGGGGGGGGGGGGGGGGGGGGGGGGGGGGGGGGGG