
G-----------------------G----------------------------------G
G-----------------------^----------------------------------G
G----------------------------------------------------------G
G---------------------------------------------------------G
G----------------------------------------------------------G
G----------------------------------------------------------G
G----------------------------------------c-----------------G
G----------------------------------------------------------G
G----G-----------------------------------------------------G
G---^G---------------------------------------------------- G
G----G-----------------------------------------------------G
G----------------------------------------------------------G
G----------------------------V------H---------------------G
G^---------------------------------------------------------G
G----------------------------------------------------------G
G----------------------------------------------------------G
G----Gc----------------------------------------------------G
G----G---------------------------------------------------- G
G-----S----------------------------------------------------G
G---B-----------B-----D----------^-------------------------G
GGGGGGGGGGGGGGGGGIIIIIIIIIIIGGGGGGGGGGGGGGGGGGGGGGGGGGGGGGGGGG
GGGGGGGGGGGGGGGGGGGGGGGGGGGGGGGGGGGGGGGGGGGGGGGGGGGGGGGGGGGGGG                                           F
GGGGGGGGGGGGGGGGGGGGGGGGGGGGGGGGGGGGGGGGGGGGGGGGGGGGGGGGGGGGGG