
G-----------------------G----------------------------------G
G-----------------------^----------------------------------G
G----------------------------------------------------------G
G----------------------------------------------------------G
G----------------------------------------------------------G
G----------------------------------------------------------G
GGGGGGGGGG----------------------------c-----------------G
G--------G-------------------------------------------------G
G----G---G-------------------------------------------------G
G---^G---G------------------------------------------------ G
G----GGGGG-------------------------------------------------G
G--------G-------------------------------------------------G
G--------G---------------------V------H---------------------G
----GGGGG-------------------------------------------------G
G----------------------------------------------------------G
G----------------------------------------------------------G
G----Gc----------------------------------------------------G
G----G---------------------------------------------------- G
G-----S----------------------------------------------------G
G------------------------------------------------------D---G
GGGGGGGGGGGGGGGGGIIIIIIIIIIIIIIIIIIIIIIIGGGGGGGGGGGGGGGGGGGGGG
GGGGGGGGGGGGGGGGGGGGGGGGGGGGGGGGGGGGGGGGGGGGGGGGGGGGGGGGGGGGGG
GGGGGGGGGGGGGGGGGGGGGGGGGGGGGGGGGGGGGGGGGGGGGGGGGGGGGGGGGGGGGG