GGGGGGGGGGGGGGGGGGGGGGGGGGGGGGGGGGGGGGGGGGGGGGGGGGG-------------------
G------------------------------------------------G--------------------
G------------------------------------------------G--------------------
G------------------------------------------------G--------------------
G------------------------------------------------G--------------------
G------------------------------------------------G--------------------
G------------------------------------------------G--------------------
G------------------------------------------------G--------------------
G------------------------------------------------G--------------------
G------------------------------------------------G--------------------
G------------------------------------------------G--------------------
G------------------------------------------------G--------------------
G------------------------------------------------G--------------------
G------------------------------------------------G--------------------
G------------------------------------------------G--------------------
G------------------------------------------------G--------------------
G------------------------------------------------G--------------------
G------------------------------------------------G--------------------
G------------------------------------------------G--------------------
G------------------------------------------------G--------------------
G------------------------------------------------G--------------------
G------------------------------------------------G--------------------
G------------------------------------------------G--------------------
G-------------K----------------------------------G--------------------
G-S----------------------------------------------G--------------------
G------------^^-------------------------------D--G--------------------
GGGGGGGGGGGGGGGGGGGGGGGGGGGGGGGGGGGGGGGGGGGGGGGGGGG-------------------
GGGGGGGGGGGGGGGGGGGGGGGGGGGGGGGGGGGGGGGGGGGGGGGGGGG-------------------
GGGGGGGGGGGGGGGGGGGGGGGGGGGGGGGGGGGGGGGGGGGGGGGGGGG-------------------
----------------------------------------------------------------------
----------------------------------------------------------------------
----------------------------------------------------------------------
----------------------------------------------------------------------
----------------------------------------------------------------------
----------------------------------------------------------------------
----------------------------------------------------------------------
----------------------------------------------------------------------
----------------------------------------------------------------------
----------------------------------------------------------------------
----------------------------------------------------------------------
----------------------------------------------------------------------
----------------------------------------------------------------------
----------------------------------------------------------------------
----------------------------------------------------------------------
----------------------------------------------------------------------
----------------------------------------------------------------------
----------------------------------------------------------------------
----------------------------------------------------------------------
----------------------------------------------------------------------
----------------------------------------------------------------------
----------------------------------------------------------------------
----------------------------------------------------------------------
----------------------------------------------------------------------
----------------------------------------------------------------------
----------------------------------------------------------------------
----------------------------------------------------------------------
----------------------------------------------------------------------
----------------------------------------------------------------------
----------------------------------------------------------------------
----------------------------------------------------------------------
----------------------------------------------------------------------
----------------------------------------------------------------------
----------------------------------------------------------------------
----------------------------------------------------------------------
----------------------------------------------------------------------
----------------------------------------------------------------------
----------------------------------------------------------------------
----------------------------------------------------------------------
----------------------------------------------------------------------
----------------------------------------------------------------------
