-------------GGG------------------------
-------------GGG------------------------
-------------GGG------------------------
-------------GGG------------------------
-G----G------GGG------------------------
-G----G------GGG------------------------
-G----G------GGG------------------------
-G----G------GGG------------------------
-G----G------GGG------------------------
-G----G------GGG------------------------
-G----G------GGG------------------------
-G----G------GGG------------------------
-G----G------GGG------------------------
-G----G------GGG------------------------
-G----G------GGG------------------------
-G----G------GGG------------------------
-G----G------GGG------------------------
-G----G------GGG------------------------
-G----G------GGG------------------------
-G----G------GGG----ggg-----------------
-G----G------GGG----GGG-----------------
-G----G------GGG----GGG-----------------
-G----G------GGG----GGG-----------------
-G----G------GGG----GGG-----------------
-G----G------GGG----GGG-----------------
-G-S----------------GGG-----------------
-G------------------GGG---------------D-
GGGGGGGGGGGGGGGGGGGGGGGGGGGGGGGGGGGAGGGGG
GGGGGGGGGGGGGGGGGGGGGGGGGGGGGGGGGGGGGGGGG
GGGGGGGGGGGGGGGGGGGGGGGGGGGGGGGGGGGGGGGGG