GGGGGGGGGGGGGGGGGGGGGGGGGGGGGGGGGGGGGGGGGGGGGGGGGGG
G-------------c------------------------------c-- G
G------------------------------------------------G
G------------------------------------------------G
G------------------------------------------------G
G------------------------------------------------G
G------------------------------------------------G
G------------------------------------------------G
G------------------------------------------------G
G------------------------------------------------G
G------------------------------------------------G
G------------------------------------------------G
G------------------------------------------------G
G-------------------------K----------------------G
G-------------------------GM--^------------------G
G-------------------------GM--GM-----------------G
G-------------------------GM--GM-----------------G
G-------------------------G--MGM-----------------G
G-------------------------G--MGM-----------------G
G-------------------------G--MGM-----------------G
G-------------------------GM--GM-----------------G
G-------------------------GM--GM-----------------G
G-------------------------GM--GM-----------------G
G-------------------------G--MGM-----------------G
G-S--------------------------MGM-----------------G
G--------^^^^----------------MGM------^-------D--G
GGGGGGGGGGGGGGGGGGGGGGGGGGGGGGGGGGGGGGGGGGGGGGGGGGG
GGGGGGGGGGGGGGGGGGGGGGGGGGGGGGGGGGGGGGGGGGGGGGGGGGG
GGGGGGGGGGGGGGGGGGGGGGGGGGGGGGGGGGGGGGGGGGGGGGGGGGG