-------------GGG------------------------
---S------------------------------
----------------------------------------
----------------------------------------
----------------------------------------
----------------------------------------
----------------------------------------
----------------------------------------
----------------------------------------
----------------------------------------
----------------------------------------
----------------------------------------
-Gc-cG---------------------------------
-Gc-cG---------------------------------
-Gc-cG---------------------------------
-Gc-cG---------------------------------
-Gc-cG---------------------------------
-Gc-cG---------------------------------
----------------------------------------
----------------------------------------
----------------------------------------
----------------------------------------
----------------------------------------
----------------------------------------
----------------------------------------
----------------------------------------
---D------------------------------------
GGG-GGGGGGGGGGGGGGGGGGGGGGGGGGGGGGGGGGGG
GGG-GGGGGGGGGGGGGGGGGGGGGGGGGGGGGGGGGGGG
GGG-GGGGGGGGGGGGGGGGGGGGGGGGGGGGGGGGGGGG