GGGGGGGGGGGGGGGGGGGGGGGGGGGGGGGGGGGGGGGGGGG
GGGGGGGGGGGGGGGGGGGGGGGGGGGGGGGGGGGGGGGGGGG
G---S----------------------------------GGG
G--------------------------------------GGG
G---------------------------------------GG
G---------------------------------------GG
G---------------------------------------GG
G---------------------------------------GG
G---------------------------------------GG
G---------------------------------------GG
G---------------------------------------GG
G---------------------------------------GG
G---------------------------------------GG
G-Gc-cG---------------------------------GG
G-Gc-cG---------------------------------GG
G-Gc-cG---------------------------------GG
G-Gc-cG---------------------------------GG
G-Gc-cG---------------------------------GG
G-Gc-cG---------------------------------GG
G---------------------------------------GG
G---------------------------------------GG
G---------------------------------------GG
G---------------------------------------GG
G---------------------------------------GG
G---------------------------------------GG
G---------------------------------------GG
G---------------------------------------GG
G---D-----------------------------------GG
GGGG-GGGGGGGGGGGGGGGGGGGGGGGGGGGGGGGGGGGGGG
GGGG-GGGGGGGGGGGGGGGGGGGGGGGGGGGGGGGGGGGGGG
GGGG-GGGGGGGGGGGGGGGGGGGGGGGGGGGGGGGGGGGGGG