GGGGGGGGGGGGGGGGGGGGGGGGGGGGGGGGGGGGGGGGGGGGGGGGGGG
G--c------------------------c----------------c-- G
G------------------------------------------------G
G------------------------------------------------G
G------------------------------------------------G
G------------------------------------------------G
G------------------------------------------------G
G------------------------------------------------G
G------------------------------------------------G
G------------------------------------------------G
G------------------------------------------------G
G------------------------------------------------G
G------------------------------------------------G
G-------------------------K----------------------G
G------------------------cGM--^------------------G
G-------------------------GM--GM-----------------G
G------------------------cGM--GM-----------------G
G-------------------------G--MGM----------------cG
G------------------------cG--MGM---------------B-G
G-------------------------G--MGM-----------------G
G-------------------------GM--GM-----------------G
G-------------------------GM--GM-----------------G
G-------------------------GM--GM-B---------------G
G-------------------------G--MGM-----------------G
G-S--------------------------MGM-----------------G
G-------------BB-------------MGM-----BB-------D--G
GGGGGGGGGGGGGGGGGGGGGGGGGGGGGGGGGGGGGGGGGGGGGGGGGGG
GGGGGGGGGGGGGGGGGGGGGGGGGGGGGGGGGGGGGGGGGGGGGGGGGGG
GGGGGGGGGGGGGGGGGGGGGGGGGGGGGGGGGGGGGGGGGGGGGGGGGGG