GGGGGGGGGGGGGGGGGGGGGGGGGGGGGGGGGGGGGGGGGGGGGGGGGGG-------------------
G--------c--------------------G--------c---------G--------------------
G-----------------------------G------------------G--------------------
G-----------------------------G------------------G--------------------
G-----------------------------G-----------------cG--------------------
G-----------------------------G------------------G--------------------
G-----------------------------G------------------G--------------------
G-----------------------------G------------------G--------------------
G--------------------^--------G------------------G--------------------
G--------------------GM-------G------------------G--------------------
G--------------------G--------G------------------G--------------------
G-------------------MG--------G------------------G--------------------
G--------------------G^^^^^---G------------------G--------------------
G--------------------GGGGGG---G------------------G--------------------
G--------------------Gc-------G------------------G--------------------
G--------------------G--------G------------------G--------------------
G--------------GGG---G--------G------------------G--------------------
G--------------------G--------G------------------G--------------------
G--------------------G--------G------------------G--------------------
G--------------------G--------G------------------G--------------------
G-----------G--------G--------G------------------G--------------------
G-----------G--------G--------G------------------G--------------------
G---------GGG--------G--------G------------------G--------------------
G--------------------G--------G------------------G--------------------
G-S------------------G---------------------------G--------------------
G-----^^^^^^^^^^^^^^^G--------------------------DG--------------------
GGGGGGGGGGGGGGGGGGGGGGGGGGGGGGGGGGGGGGGGGGGGGGGGGG--------------------
GGGGGGGGGGGGGGGGGGGGGGGGGGGGGGGGGGGGGGGGGGGGGGGGGGG-------------------
GGGGGGGGGGGGGGGGGGGGGGGGGGGGGGGGGGGGGGGGGGGGGGGGGGG-------------------
----------------------------------------------------------------------
----------------------------------------------------------------------
----------------------------------------------------------------------
----------------------------------------------------------------------
----------------------------------------------------------------------
----------------------------------------------------------------------
----------------------------------------------------------------------
----------------------------------------------------------------------
----------------------------------------------------------------------
----------------------------------------------------------------------
----------------------------------------------------------------------
----------------------------------------------------------------------
----------------------------------------------------------------------
----------------------------------------------------------------------
----------------------------------------------------------------------
----------------------------------------------------------------------
----------------------------------------------------------------------
----------------------------------------------------------------------
----------------------------------------------------------------------
----------------------------------------------------------------------
----------------------------------------------------------------------
----------------------------------------------------------------------
----------------------------------------------------------------------
----------------------------------------------------------------------
----------------------------------------------------------------------
----------------------------------------------------------------------
----------------------------------------------------------------------
----------------------------------------------------------------------
----------------------------------------------------------------------
----------------------------------------------------------------------
----------------------------------------------------------------------
----------------------------------------------------------------------
----------------------------------------------------------------------
----------------------------------------------------------------------
----------------------------------------------------------------------
----------------------------------------------------------------------
----------------------------------------------------------------------
----------------------------------------------------------------------
----------------------------------------------------------------------
----------------------------------------------------------------------
----------------------------------------------------------------------
