GGGGGGGGGGGGGGGGGGGGGGGGGGGGGGGGGGGGGGGGGGGGGGGGGGG-------------------
G----------------------G------------------------cG--------------------
Gl------i--------------G-------G----------------cG--------------------
Gl------i----------------------GGGG-------------cG--------------------
Gl------i--GG--G------G---G--G----G--G----------cG--------------------
Gli-----iG----G--GG-G-GG---G-------G------------cG--------------------
Gli-------G----------G------G---G-------G-------cG--------------------
Gli-----G--------G-G--GG------p----G------------cG--------------------
Gli----GG---G---------G-G-----------Gp----G-----cG--------------------
Gli------------G----G-G---G---------------------cG--------------------
Gli----G---------p----G-----------G---G---------cG--------------------
Gl--------i-----------G--GG----p-GG--------G----cG--------------------
Gl-----G--i---G-----GGG----------GG---G---------cG--------------------
Gl----G--i----------G-G--G--------------p---G---cG--------------------
Gl-------i----G-----GGG---------GG----G---------cG--------------------
Gl-----G----------p--GG--GGp----G----G----------cG--------------------
Gl-----G------G-------G----------G----------G---cG--------------------
Gl---------i----G-----G--GG----G-GGG------G-----cG--------------------
G-------G--ii-i-----G-G-G--G---GG---GG-G-G------cG--------------------
Gl---------ii-i---G--GGG------G-----------------cG--------------------
Gl------GG-ii-i-------G-----GG------------------cG--------------------
Gl--------Gii-i---G---G------------p------------cG--------------------
Gl--------Gii-i-------GGG-G-G-------------------cG--------------------
Gl------G--iGGiG-------G-GGG--------------------cG--------------------
GlS-----G--ii-iG--G--G--------------------------cG--------------------
G-------G---i-i-------------e--e---e-e---ee-e---cG--------------------
GGGGGGGGGGGGGGGGGGGGGGGGGGGGGGGGeGGGGGGGGGGGGGGGGG--------------------
GGGGGGGGGGGGGGGGGGGGGGGGGGGGGGGGGGGGGGGGGGGGGGGGGGG-------------------
GGGGGGGGGGGGGGGGGGGGGGGGGGGGGGGGGGGGGGGGGGGGGGGGGGG-------------------
----------------------------------------------------------------------
----------------------------------------------------------------------
----------------------------------------------------------------------
----------------------------------------------------------------------
----------------------------------------------------------------------
----------------------------------------------------------------------
----------------------------------------------------------------------
----------------------------------------------------------------------
----------------------------------------------------------------------
----------------------------------------------------------------------
----------------------------------------------------------------------
----------------------------------------------------------------------
----------------------------------------------------------------------
----------------------------------------------------------------------
----------------------------------------------------------------------
----------------------------------------------------------------------
----------------------------------------------------------------------
----------------------------------------------------------------------
----------------------------------------------------------------------
----------------------------------------------------------------------
----------------------------------------------------------------------
----------------------------------------------------------------------
----------------------------------------------------------------------
----------------------------------------------------------------------
----------------------------------------------------------------------
----------------------------------------------------------------------
----------------------------------------------------------------------
----------------------------------------------------------------------
----------------------------------------------------------------------
----------------------------------------------------------------------
----------------------------------------------------------------------
----------------------------------------------------------------------
----------------------------------------------------------------------
----------------------------------------------------------------------
----------------------------------------------------------------------
----------------------------------------------------------------------
----------------------------------------------------------------------
----------------------------------------------------------------------
----------------------------------------------------------------------
----------------------------------------------------------------------
----------------------------------------------------------------------
