GGGGGGGGGGGGGGGGGGGGGGGGGGGGGGGGGGGGGGGGGGGGGGGGGGG-------------------
G---------------------GD-------------------------G--------------------
G--------------------eGG-------------------------G--------------------
G---------------------G--------------------------G--------------------
G--GGGGGGGGG--------GGG----MG--------------------G--------------------
G--G---------------------------------------------G--------------------
GM-G---------------------------------------------G--------------------
GM-G----------------------G----------------------G--------------------
GM-G--------------GGG-----G----------------------G--------------------
G--G----------------------G----------------------G--------------------
G--G---------------------------------------------G--------------------
G-MG---------------------------------------------G--------------------
G-MG---------------------------------------------G--------------------
G------------------------------------------------G--------------------
G------------------------------------------------G--------------------
GK----i--B---i-----------------------------------G--------------------
GGGG---GGGGGG----GGGGM---------------------------G--------------------
G------------------------------------------------G--------------------
G------------------------------------------------G--------------------
G------------------------------------------------G--------------------
G-----------------------------------------------lG--------------------
G-----------------------G------------------------G--------------------
G-----------------------G-----------------------KG--------------------
G-----------------------G----------^G^---^G^-----G--------------------
G-S----------N-N--------G---NNNNN---^-----^-----^G--------------------
G----GLLLLLLLLGLLLLLLLLGGLLLLLLLLLLLLLLLLLLLLLLLLG--------------------
GGGGGGGGGGGGGGGGGGGGGGGGGGGGGGGGGGGGGGGGGGGGGGGGGGG-------------------
GGGGGGGGGGGGGGGGGGGGGGGGGGGGGGGGGGGGGGGGGGGGGGGGGGG-------------------
GGGGGGGGGGGGGGGGGGGGGGGGGGGGGGGGGGGGGGGGGGGGGGGGGGG-------------------
----------------------------------------------------------------------
----------------------------------------------------------------------
----------------------------------------------------------------------
----------------------------------------------------------------------
----------------------------------------------------------------------
----------------------------------------------------------------------
----------------------------------------------------------------------
----------------------------------------------------------------------
----------------------------------------------------------------------
----------------------------------------------------------------------
----------------------------------------------------------------------
----------------------------------------------------------------------
----------------------------------------------------------------------
----------------------------------------------------------------------
----------------------------------------------------------------------
----------------------------------------------------------------------
----------------------------------------------------------------------
----------------------------------------------------------------------
----------------------------------------------------------------------
----------------------------------------------------------------------
----------------------------------------------------------------------
----------------------------------------------------------------------
----------------------------------------------------------------------
----------------------------------------------------------------------
----------------------------------------------------------------------
----------------------------------------------------------------------
----------------------------------------------------------------------
----------------------------------------------------------------------
----------------------------------------------------------------------
----------------------------------------------------------------------
----------------------------------------------------------------------
----------------------------------------------------------------------
----------------------------------------------------------------------
----------------------------------------------------------------------
----------------------------------------------------------------------
----------------------------------------------------------------------
----------------------------------------------------------------------
----------------------------------------------------------------------
----------------------------------------------------------------------
----------------------------------------------------------------------
----------------------------------------------------------------------
