GGGGGGGGGGGGGGGGGGGGGGGGGGGGGGGGGGGGGGGGGGGGGGGGGGG-------------------
G---------------------GD-------------------------G--------------------
G--------------------eGG-------------------------G--------------------
G-----^^--------------G--------------------------G--------------------
G--GGGGGGGGG--------GGG----MG--------------------G--------------------
G--Gc--------------------------------------------G--------------------
GM-G---------------------------------------------G--------------------
GM-G----------------------G----------------------G--------------------
GM-G--------------GGG-----G----------------------G--------------------
G^-G----------------G-----G----------------------G--------------------
G^-G----------------G----------------------------G--------------------
G-MG----------------G----------------------------G--------------------
G-MG----------------G----------------------------G--------------------
G------------------------------------------------G--------------------
G------------------------------------------------G--------------------
GK----BB-----i-----------------------------------G--------------------
GGGGGGGGGGGGG----GGGGM---------------------------G--------------------
G------------------------------------------------G--------------------
G------------------------------------------------G--------------------
G------------------------------------------------G--------------------
G------------------------------------------------G--------------------
G-----------------------G------------------------G--------------------
G---------^--------^----G-----------^-----^-----KG--------------------
G--------^G^------^G^---G-^G^------^G^---^G^----^G--------------------
G-S-------^-NN-----^-NN-G--^NNN-----^-----^-----^G--------------------
G----GLLLLLLLLGLLLLLLLLGGLLLLLLLLLLLLLLLLLLLLLLLLG--------------------
GGGGGGGGGGGGGGGGGGGGGGGGGGGGGGGGGGGGGGGGGGGGGGGGGGG-------------------
GGGGGGGGGGGGGGGGGGGGGGGGGGGGGGGGGGGGGGGGGGGGGGGGGGG-------------------
GGGGGGGGGGGGGGGGGGGGGGGGGGGGGGGGGGGGGGGGGGGGGGGGGGG-------------------
----------------------------------------------------------------------
----------------------------------------------------------------------
----------------------------------------------------------------------
----------------------------------------------------------------------
----------------------------------------------------------------------
----------------------------------------------------------------------
----------------------------------------------------------------------
----------------------------------------------------------------------
----------------------------------------------------------------------
----------------------------------------------------------------------
----------------------------------------------------------------------
----------------------------------------------------------------------
----------------------------------------------------------------------
----------------------------------------------------------------------
----------------------------------------------------------------------
----------------------------------------------------------------------
----------------------------------------------------------------------
----------------------------------------------------------------------
----------------------------------------------------------------------
----------------------------------------------------------------------
----------------------------------------------------------------------
----------------------------------------------------------------------
----------------------------------------------------------------------
----------------------------------------------------------------------
----------------------------------------------------------------------
----------------------------------------------------------------------
----------------------------------------------------------------------
----------------------------------------------------------------------
----------------------------------------------------------------------
----------------------------------------------------------------------
----------------------------------------------------------------------
----------------------------------------------------------------------
----------------------------------------------------------------------
----------------------------------------------------------------------
----------------------------------------------------------------------
----------------------------------------------------------------------
----------------------------------------------------------------------
----------------------------------------------------------------------
----------------------------------------------------------------------
----------------------------------------------------------------------
----------------------------------------------------------------------
