GGGGGGGGGGGGGGGGGGGGGGGGGGGGGGGGGGGGGGGGGGGGGGGGGGG-------------------
G------------------------------------------------G--------------------
GM-GG--------------------------------------------G--------------------
G---G--i---------------B^^^^B----------------i---G--------------------
G--MGM--GGGGGGGGGGGGGGGGGGGGGGGGGGGGGGGGGGGGG----G--------------------
G-p-GM--G----------------------------------------G--------------------
G---GM--G----------------------------------------G--------------------
GK--G---G----------------------------------------G--------------------
GGGGG---G-----^------^------^------^------^------G--------------------
G-------G----^G^----^G^----^G^----^G^----^G^-----G--------------------
G-------G-----^------^------^------^------^-NNNN^G--------------------
G----^^^G--GLLLLLLLLLLLLLLLLLLLLLLLLLLLLLLLLLLLLLG--------------------
G---GGGGG--GGGGGGGGGGGGGGGGGGGGGGGGGGGGGGGGGGGGGGG--------------------
GM--G--------------------------------------------G--------------------
GM--G------G-------------------------------------G--------------------
G^--G------G-----------------------------K------eG--------------------
G^--G------G-----------------BB------------------G--------------------
GM--G--GGGGGGGGGGGGGGGGGGGGGGGGGGGGGGGGGGGGGGGGGGG--------------------
GM--G-----------------------------------c-------cG--------------------
G^--G--------------------------------------------G--------------------
G^--G--------------------------------------------G--------------------
G--MG--------------------------------------------G--------------------
G--MG--------------------K-----------------------G--------------------
G---G-------------------------------------------lG--------------------
G-S-G--------------------------------------------G--------------------
G---G-------------^^^^--------^^^^------------D--G--------------------
GGGGGGGGGGGGGGGGGGGGGGGGGGGGGGGGGGGGGGGGGGGGGGGGGGG-------------------
GGGGGGGGGGGGGGGGGGGGGGGGGGGGGGGGGGGGGGGGGGGGGGGGGGG-------------------
GGGGGGGGGGGGGGGGGGGGGGGGGGGGGGGGGGGGGGGGGGGGGGGGGGG-------------------
----------------------------------------------------------------------
----------------------------------------------------------------------
----------------------------------------------------------------------
----------------------------------------------------------------------
----------------------------------------------------------------------
----------------------------------------------------------------------
----------------------------------------------------------------------
----------------------------------------------------------------------
----------------------------------------------------------------------
----------------------------------------------------------------------
----------------------------------------------------------------------
----------------------------------------------------------------------
----------------------------------------------------------------------
----------------------------------------------------------------------
----------------------------------------------------------------------
----------------------------------------------------------------------
----------------------------------------------------------------------
----------------------------------------------------------------------
----------------------------------------------------------------------
----------------------------------------------------------------------
----------------------------------------------------------------------
----------------------------------------------------------------------
----------------------------------------------------------------------
----------------------------------------------------------------------
----------------------------------------------------------------------
----------------------------------------------------------------------
----------------------------------------------------------------------
----------------------------------------------------------------------
----------------------------------------------------------------------
----------------------------------------------------------------------
----------------------------------------------------------------------
----------------------------------------------------------------------
----------------------------------------------------------------------
----------------------------------------------------------------------
----------------------------------------------------------------------
----------------------------------------------------------------------
----------------------------------------------------------------------
----------------------------------------------------------------------
----------------------------------------------------------------------
----------------------------------------------------------------------
----------------------------------------------------------------------
