GGGGGGGGGGGGGGGGGGGGGGGGGGGGGGGGGGGGGGGGGGGGGGGGGGG-------------------
G--------^^----------lGK------------------------DG--------------------
GM-------------------eGG-----------------------^GG--------------------
GM----^^--------------G------------------------GGG--------------------
GM-GGGGGGGGG--------GGG----MG----------------^GG-G--------------------
G^-Gc----------------------------------------GG--G--------------------
GM-G----------------------^----------------^GG---G--------------------
GM-G---------------------MG----------------GG----G--------------------
GM-G--------------GGG----MG--------------^GG-----G--------------------
G^-G--------------l-G----MG--------------GG------G--------------------
G^-G----------------G-----^----i----B----G-------G--------------------
G-MG----------------G-----------GGGGGGGGGG-------G--------------------
G-MG----------------G----------------------------G--------------------
G------------------------------------------------G--------------------
G------------------------------------------------G--------------------
GK----BB-----i-----------------------------------G--------------------
GGGGGGGGGGGGG----GGGG----------------------------G--------------------
G------------------------------------------------G--------------------
G-----------------------GM-----------------------G--------------------
G------------------------------------------------G--------------------
G------------------------------------------------G--------------------
G-----------------------^-----------^------------G--------------------
G---------^--------^----G----------^G^----^-----KG--------------------
G--------^G^------^G^---G-^G^------^G^---^G^----^G--------------------
G-S-------^-NN-----^-NN-G--^NNN-----^-----^-----^G--------------------
G----GLLLLLLLLGLLLLLLLLGGLLLLLLLLLLLLLLLLLLLLLLLLG--------------------
GGGGGGGGGGGGGGGGGGGGGGGGGGGGGGGGGGGGGGGGGGGGGGGGGGG-------------------
GGGGGGGGGGGGGGGGGGGGGGGGGGGGGGGGGGGGGGGGGGGGGGGGGGG-------------------
GGGGGGGGGGGGGGGGGGGGGGGGGGGGGGGGGGGGGGGGGGGGGGGGGGG-------------------
----------------------------------------------------------------------
----------------------------------------------------------------------
----------------------------------------------------------------------
----------------------------------------------------------------------
----------------------------------------------------------------------
----------------------------------------------------------------------
----------------------------------------------------------------------
----------------------------------------------------------------------
----------------------------------------------------------------------
----------------------------------------------------------------------
----------------------------------------------------------------------
----------------------------------------------------------------------
----------------------------------------------------------------------
----------------------------------------------------------------------
----------------------------------------------------------------------
----------------------------------------------------------------------
----------------------------------------------------------------------
----------------------------------------------------------------------
----------------------------------------------------------------------
----------------------------------------------------------------------
----------------------------------------------------------------------
----------------------------------------------------------------------
----------------------------------------------------------------------
----------------------------------------------------------------------
----------------------------------------------------------------------
----------------------------------------------------------------------
----------------------------------------------------------------------
----------------------------------------------------------------------
----------------------------------------------------------------------
----------------------------------------------------------------------
----------------------------------------------------------------------
----------------------------------------------------------------------
----------------------------------------------------------------------
----------------------------------------------------------------------
----------------------------------------------------------------------
----------------------------------------------------------------------
----------------------------------------------------------------------
----------------------------------------------------------------------
----------------------------------------------------------------------
----------------------------------------------------------------------
----------------------------------------------------------------------
