GGGGGGGGGGGGGGGGGGGGGGGGGGGGGGGGGGGGGGGGGGGGGGGGGGG-------------------
G------------l---l-------------G-----KG----------G--------------------
G------------------------------G------G----------G--------------------
G------------------------------GMG-GGGG----------G--------------------
Ge-----------------------------GMG-------G-------G--------------------
G------------------------------GMG-------G--^----G--------------------
G------------------------------GMG-------G-MG^---G--------------------
G------------------------------GMG-------G--^----G--------------------
G------------------------------G-G--p----G-----G-G--------------------
G------------------------------G---------G-------G--------------------
G-----------i--B--i----------------------G-------G--------------------
GD----B------GGGGG-----^^^---------------G-------G--------------------
GGGGGGGGGGGGGG---GGGGGGGGGGGGGGGGGGGGGGGGGGGGGGG-G--------------------
GK------------------^-----^----------------------G--------------------
G-------------^G^N-^G^N--^G^---------------------G--------------------
G^----------^--^----^-----^------^------^-----GGGG--------------------
G^---------MG^------------------^G^----^G^-------G--------------------
G-----------^-------------------^G^----^G^-------G--------------------
G-----------^^^^^^^^^^^^^^^----N-^------^--------G--------------------
GGGGGGGGG--GGGGGGGGGGGGGGGGLLLLLLLLLLLLLLLLLLLG--G--------------------
G-------------------------GGGGGGGGGGGGGGGGGGGGG--G--------------------
Gl------------------------G------------------KG-MG--------------------
Ge------------------------G------^------^-----G--G--------------------
GGGGGGGGGGGGGGGGGGGGGGG---G---GGGGGGGGGGGGGGGGG--G--------------------
G-S-----^^----^^----------G----------------------G--------------------
G----^^----^^----B--------G---------BB-----------G--------------------
GGGGGGGGGGGGGGGGGGGGGGGGGGGGGGGGGGGGGGGGGGGGGGGGGG--------------------
GGGGGGGGGGGGGGGGGGGGGGGGGGGGGGGGGGGGGGGGGGGGGGGGGGG-------------------
GGGGGGGGGGGGGGGGGGGGGGGGGGGGGGGGGGGGGGGGGGGGGGGGGGG-------------------
----------------------------------------------------------------------
----------------------------------------------------------------------
----------------------------------------------------------------------
----------------------------------------------------------------------
----------------------------------------------------------------------
----------------------------------------------------------------------
----------------------------------------------------------------------
----------------------------------------------------------------------
----------------------------------------------------------------------
----------------------------------------------------------------------
----------------------------------------------------------------------
----------------------------------------------------------------------
----------------------------------------------------------------------
----------------------------------------------------------------------
----------------------------------------------------------------------
----------------------------------------------------------------------
----------------------------------------------------------------------
----------------------------------------------------------------------
----------------------------------------------------------------------
----------------------------------------------------------------------
----------------------------------------------------------------------
----------------------------------------------------------------------
----------------------------------------------------------------------
----------------------------------------------------------------------
----------------------------------------------------------------------
----------------------------------------------------------------------
----------------------------------------------------------------------
----------------------------------------------------------------------
----------------------------------------------------------------------
----------------------------------------------------------------------
----------------------------------------------------------------------
----------------------------------------------------------------------
----------------------------------------------------------------------
----------------------------------------------------------------------
----------------------------------------------------------------------
----------------------------------------------------------------------
----------------------------------------------------------------------
----------------------------------------------------------------------
----------------------------------------------------------------------
----------------------------------------------------------------------
----------------------------------------------------------------------
