GGGGGGGGGGGGGGGGGGGGGGGGGGGGGGGGGGGGGGGGGGGGGGGGGGG-------------------
G------------^^-----------------------^^---------G--------------------
GM-GG--------------------------------------------G--------------------
G---G--i---------------B^^^^B----------------i---G--------------------
G--MGM--GGGGGGGGGGGGGGGGGGGGGGGGGGGGGGGGGGGGG----G--------------------
G-p-GM--G----------------------------------------G--------------------
G---GM--G----------------------------------------G--------------------
GK--G---G----------------------------------------G--------------------
GGGGG---G-----^------^------^------^------^------G--------------------
G-------G----^G^-^^-^G^-^^-^G^-^^-^G^-^^-^G^^----G--------------------
G-------G-----^-GGGG-^-GGGG-^-GGGG-^-GGGG-^-GG---G--------------------
G----^^^G--GLLLLLLLLLLLLLLLLLLLLLLLLLLLLLLLLLLLLLG--------------------
G--^GGGGG--GGGGGGGGGGGGGGGGGGGGGGGGGGGGGGGGGGGGGGG--------------------
GM-^G--------------------------------------------G--------------------
GM--G------G-------------------------------------G--------------------
G^--G------Ge----------------------------K------eG--------------------
GM--G---^^^G-----------------BB------------------G--------------------
GM--G--GGGGGGGGGGGGGGGGGGGGGGGGGGGGGGGGGGGGGGGGGGG--------------------
GM--G---------------e-----l----------------------G--------------------
G^--G-------------------------------------------eG--------------------
G^--G--------------------------------------------G--------------------
G--MG--------------------------------------------G--------------------
G--MG--------------------K-----------------------G--------------------
G---G-------------------------------------------lG--------------------
G-S-G--------------------------------------------G--------------------
G---G-------------^^^^--------^^^^------------D--G--------------------
GGGGGGGGGGGGGGGGGGGGGGGGGGGGGGGGGGGGGGGGGGGGGGGGGGG-------------------
GGGGGGGGGGGGGGGGGGGGGGGGGGGGGGGGGGGGGGGGGGGGGGGGGGG-------------------
GGGGGGGGGGGGGGGGGGGGGGGGGGGGGGGGGGGGGGGGGGGGGGGGGGG-------------------
----------------------------------------------------------------------
----------------------------------------------------------------------
----------------------------------------------------------------------
----------------------------------------------------------------------
----------------------------------------------------------------------
----------------------------------------------------------------------
----------------------------------------------------------------------
----------------------------------------------------------------------
----------------------------------------------------------------------
----------------------------------------------------------------------
----------------------------------------------------------------------
----------------------------------------------------------------------
----------------------------------------------------------------------
----------------------------------------------------------------------
----------------------------------------------------------------------
----------------------------------------------------------------------
----------------------------------------------------------------------
----------------------------------------------------------------------
----------------------------------------------------------------------
----------------------------------------------------------------------
----------------------------------------------------------------------
----------------------------------------------------------------------
----------------------------------------------------------------------
----------------------------------------------------------------------
----------------------------------------------------------------------
----------------------------------------------------------------------
----------------------------------------------------------------------
----------------------------------------------------------------------
----------------------------------------------------------------------
----------------------------------------------------------------------
----------------------------------------------------------------------
----------------------------------------------------------------------
----------------------------------------------------------------------
----------------------------------------------------------------------
----------------------------------------------------------------------
----------------------------------------------------------------------
----------------------------------------------------------------------
----------------------------------------------------------------------
----------------------------------------------------------------------
----------------------------------------------------------------------
----------------------------------------------------------------------
