GGGGGGGGGGGGGGGGGGGGGGGGGGGGGGGGGGGGGGGGGGGGGGGGGGG-------------------
G------------l---l-------------G-----KG----------G--------------------
G------------------------------G------G----------G--------------------
G------------------------------GMG-GGGG----------G--------------------
Ge-----------------------------GMG------GG-------G--------------------
G------------------------------GMG-------G--^----G--------------------
G------------------------------GMG-------G-MG^---G--------------------
G------------------------------GMG-------G--^----G--------------------
G------------------------------G-G--p----G-----G-G--------------------
G------------------------------G---------G-------G--------------------
G-----------i--B--i------------GG--------G-------G--------------------
GD----B------GGGGG-----^^^---------------G-------G--------------------
GGGGGGGGGGGGGG---GGGGGGGGGGGGGGGGGGGGGGGGGGGGGGG-G--------------------
G-------------------^-----^----------------------G--------------------
GK-------------G^N-^G^N--^G^---------------------G--------------------
G--------------^-----------------^------^----^GGGG--------------------
G^----------G^------------------^G^----^G^-------G--------------------
G-----------^----------------^^-^G^-^^-^G^-^^----G--------------------
G-----------^^^^^^^^^^^^^^^-GGGG-^-GGGG-^-GGG----G--------------------
GGGGGGGGG--GGGGGGGGGGGGGGGGLLLLLLLLLLLLLLLLLLLG--G--------------------
G-------------------------GGGGGGGGGGGGGGGGGGGGG--G--------------------
Gl------------------------G------------------KG-MG--------------------
Ge------------------------G------^------^-----G--G--------------------
GGGGGGGGGGGGGGGGGGGGGGG---G---GGGGGGGGGGGGGGGGG--G--------------------
G-S--^^--^^--^^--^^-------G----------------------G--------------------
G----------------B--------G---------BB-----------G--------------------
GGGGGGGGGGGGGGGGGGGGGGGGGGGGGGGGGGGGGGGGGGGGGGGGGG--------------------
GGGGGGGGGGGGGGGGGGGGGGGGGGGGGGGGGGGGGGGGGGGGGGGGGGG-------------------
GGGGGGGGGGGGGGGGGGGGGGGGGGGGGGGGGGGGGGGGGGGGGGGGGGG-------------------
----------------------------------------------------------------------
----------------------------------------------------------------------
----------------------------------------------------------------------
----------------------------------------------------------------------
----------------------------------------------------------------------
----------------------------------------------------------------------
----------------------------------------------------------------------
----------------------------------------------------------------------
----------------------------------------------------------------------
----------------------------------------------------------------------
----------------------------------------------------------------------
----------------------------------------------------------------------
----------------------------------------------------------------------
----------------------------------------------------------------------
----------------------------------------------------------------------
----------------------------------------------------------------------
----------------------------------------------------------------------
----------------------------------------------------------------------
----------------------------------------------------------------------
----------------------------------------------------------------------
----------------------------------------------------------------------
----------------------------------------------------------------------
----------------------------------------------------------------------
----------------------------------------------------------------------
----------------------------------------------------------------------
----------------------------------------------------------------------
----------------------------------------------------------------------
----------------------------------------------------------------------
----------------------------------------------------------------------
----------------------------------------------------------------------
----------------------------------------------------------------------
----------------------------------------------------------------------
----------------------------------------------------------------------
----------------------------------------------------------------------
----------------------------------------------------------------------
----------------------------------------------------------------------
----------------------------------------------------------------------
----------------------------------------------------------------------
----------------------------------------------------------------------
----------------------------------------------------------------------
----------------------------------------------------------------------
