GGGGGGGGGGGGGGGGGGGGGGGGGGGGGGGGGGGGGGGGGGGGGGGGGGG-------------------
G------------l---l--------G---KG-----KG----------G--------------------
G-------------------------G-MGGG------G-GG-^-----G--------------------
G-------------------------G----GMG-GGGG--GMG^----G--------------------
Ge------------------------G-B--GMG--G----G-^-----G--------------------
G-------------------------G----GMG--G----G--^----G--------------------
G-------------------------GM---GMG-------G-MG^---G--------------------
G-------------------------GM---G---------G--^----G--------------------
G-------------------------G---------p----G-----G-G--------------------
G-------------------------G----G---------G-------G--------------------
G-----------i--B--i------------GG--------G-------G--------------------
GD----B------GGGGG-----^^^---------------G-------G--------------------
GGGGGGGGGGGGGG---GGGGGGGGGGGGGGGGGGGGGGGGGGGGGGG-G--------------------
GK------------------^-----^----l------l----------G--------------------
G--------------G^N-^G^N--^G^---------------------G--------------------
G^-------------^----^-----^------^------^----^GGGG--------------------
G^----------G^------------------^G^----^G^----l--G--------------------
G-----------^----------------^^-^G^-^^-^G^-^^----G--------------------
G---B----i--^^^^^^^^^^^^^^^-GGGG-^-GGGG-^-GGG----G--------------------
GGGGGGGGG--GGGGGGGGGGGGGGGGLLLLLLLLLLLLLLLLLLLG--G--------------------
G-------------------------GGGGGGGGGGGGGGGGGGGGG--G--------------------
Gl------------------------G--------^------^--KG-MG--------------------
Ge------------------------G------^------^-----G--G--------------------
GGGGGGGGGGGGGGGGGGGGGGG---G---GGGGGGGGGGGGGGGGG--G--------------------
G-S-----------------------G----------^-----------G--------------------
G----^^----^^----B--------G---------BB-----------G--------------------
GGGGGGGGGGGGGGGGGGGGGGGGGGGGGGGGGGGGGGGGGGGGGGGGGG--------------------
GGGGGGGGGGGGGGGGGGGGGGGGGGGGGGGGGGGGGGGGGGGGGGGGGGG-------------------
GGGGGGGGGGGGGGGGGGGGGGGGGGGGGGGGGGGGGGGGGGGGGGGGGGG-------------------
----------------------------------------------------------------------
----------------------------------------------------------------------
----------------------------------------------------------------------
----------------------------------------------------------------------
----------------------------------------------------------------------
----------------------------------------------------------------------
----------------------------------------------------------------------
----------------------------------------------------------------------
----------------------------------------------------------------------
----------------------------------------------------------------------
----------------------------------------------------------------------
----------------------------------------------------------------------
----------------------------------------------------------------------
----------------------------------------------------------------------
----------------------------------------------------------------------
----------------------------------------------------------------------
----------------------------------------------------------------------
----------------------------------------------------------------------
----------------------------------------------------------------------
----------------------------------------------------------------------
----------------------------------------------------------------------
----------------------------------------------------------------------
----------------------------------------------------------------------
----------------------------------------------------------------------
----------------------------------------------------------------------
----------------------------------------------------------------------
----------------------------------------------------------------------
----------------------------------------------------------------------
----------------------------------------------------------------------
----------------------------------------------------------------------
----------------------------------------------------------------------
----------------------------------------------------------------------
----------------------------------------------------------------------
----------------------------------------------------------------------
----------------------------------------------------------------------
----------------------------------------------------------------------
----------------------------------------------------------------------
----------------------------------------------------------------------
----------------------------------------------------------------------
----------------------------------------------------------------------
----------------------------------------------------------------------
