GGGGGGGGGGGGGGGGGGGGGGGGGGGGGGGGGGGGGGGGGGGGGGGGGGG-------------------
G------------l---l--------G---KG-----KG----------G--------------------
G-------------------------G-MGGG------G-GG--^----G--------------------
G-------------------------G-B--GMG-GGGG--G-^GM---G--------------------
Ge-----------------------eG-B--G----G----G-------G--------------------
G-------------------------G----G----G----G--^----G--------------------
G-------------------------GM---GMG--G----G-MG^---G--------------------
G-------------------------GM---G---------G--^----G--------------------
G-----------------------------------p----G-----G-G--------------------
G-------------------------G----GG--------G-------G--------------------
G-----------i--B--i------------G---------G-------G--------------------
GDB---------BGGGGG----^^^^-----G---------G-------G--------------------
GGGGGGGGGGGGGG---GGGGGGGGGGGGGGGGGGGGGGGGGGGGGGG-G--------------------
GK------------------^-----^----l------l----------G--------------------
G^------------^G^N-^G^N--^G^--------------------lG--------------------
G^-------------^----^-----^------^------^----^GGGG--------------------
G^---------^Gl------------------^G^----^G^----l--G--------------------
G-----------^----------------^^-^G^-^^-^G^-^^----G--------------------
G---B----i--^^^^^^^^^^^^^^^-GGGG-^-GGGG-^-GGG----G--------------------
GGGGGGGGG--GGGGGGGGGGGGGGGGLLLLLLLLLLLLLLLLLLLG--G--------------------
G-------------------------GGGGGGGGGGGGGGGGGGGGG--G--------------------
Gl------------------------G-l----^---^---^---KG-MG--------------------
Ge------------------------G----^---^---^---^--G--G--------------------
GGGGGGGGGGGGGGGGGGGGGGG---G---GGGGGGGGGGGGGGGGG--G--------------------
G-S-----^^----------------G----------^-----------G--------------------
G----^^----^^----B--------G---------BB-----------G--------------------
GGGGGGGGGGGGGGGGGGGGGGGGGGGGGGGGGGGGGGGGGGGGGGGGGG--------------------
GGGGGGGGGGGGGGGGGGGGGGGGGGGGGGGGGGGGGGGGGGGGGGGGGGG-------------------
GGGGGGGGGGGGGGGGGGGGGGGGGGGGGGGGGGGGGGGGGGGGGGGGGGG-------------------
----------------------------------------------------------------------
----------------------------------------------------------------------
----------------------------------------------------------------------
----------------------------------------------------------------------
----------------------------------------------------------------------
----------------------------------------------------------------------
----------------------------------------------------------------------
----------------------------------------------------------------------
----------------------------------------------------------------------
----------------------------------------------------------------------
----------------------------------------------------------------------
----------------------------------------------------------------------
----------------------------------------------------------------------
----------------------------------------------------------------------
----------------------------------------------------------------------
----------------------------------------------------------------------
----------------------------------------------------------------------
----------------------------------------------------------------------
----------------------------------------------------------------------
----------------------------------------------------------------------
----------------------------------------------------------------------
----------------------------------------------------------------------
----------------------------------------------------------------------
----------------------------------------------------------------------
----------------------------------------------------------------------
----------------------------------------------------------------------
----------------------------------------------------------------------
----------------------------------------------------------------------
----------------------------------------------------------------------
----------------------------------------------------------------------
----------------------------------------------------------------------
----------------------------------------------------------------------
----------------------------------------------------------------------
----------------------------------------------------------------------
----------------------------------------------------------------------
----------------------------------------------------------------------
----------------------------------------------------------------------
----------------------------------------------------------------------
----------------------------------------------------------------------
----------------------------------------------------------------------
----------------------------------------------------------------------
