GGGGGGGGGGGGGGGGGGGGGGGGGGGGGGGGGGGGGGGGGGGGGGGGGGG-------------------
G------------------------------------------------G--------------------
G------------------------------------------------G--------------------
G------------------------------------------------G--------------------
G------------------------------------------------G--------------------
G------------------------------------------------G--------------------
G------------------------------------------------G--------------------
G-----------------MG-----------------GGGG--------G--------------------
G------GM----------G-----------------------------G--------------------
G------GM----------G-----------------------------G--------------------
G------GM----------G-----------------------------G--------------------
G------GM----------G-----------------------------G--------------------
G------GM----------GM----------------------------G--------------------
G------GM----------------------------------------G--------------------
G------GM----------------------------------------G--------------------
G------GM----------------------------------------G--------------------
G------GM--------------^-------------------------G--------------------
G------GM-------------MGM------------------------G--------------------
G------G--------------MGM------------------------G--------------------
G---------------------MGM----G-------------------G--------------------
G---------------------MGM---MGM------------------G--------------------
G---------------------MGM---^GM------------------G--------------------
G---------------------MGM---MGM------------------G--------------------
G---------------------------MGM------------------G--------------------
G-S----------------------------------------------G--------------------
G--------^-------------------------------------D-G--------------------
GGGGGGGGGGGGGG----------------------GGGGGGGGGGGG----------------------
GGGGGGGGGGGGGGGGGGGGGGGGGGGGGGGGGGGGGGGGGGGGGGGGGGG-------------------
GGGGGGGGGGGGGGGGGGGGGGGGGGGGGGGGGGGGGGGGGGGGGGGGGGG-------------------
----------------------------------------------------------------------
----------------------------------------------------------------------
----------------------------------------------------------------------
----------------------------------------------------------------------
----------------------------------------------------------------------
----------------------------------------------------------------------
----------------------------------------------------------------------
----------------------------------------------------------------------
----------------------------------------------------------------------
----------------------------------------------------------------------
----------------------------------------------------------------------
----------------------------------------------------------------------
----------------------------------------------------------------------
----------------------------------------------------------------------
----------------------------------------------------------------------
----------------------------------------------------------------------
----------------------------------------------------------------------
----------------------------------------------------------------------
----------------------------------------------------------------------
----------------------------------------------------------------------
----------------------------------------------------------------------
----------------------------------------------------------------------
----------------------------------------------------------------------
----------------------------------------------------------------------
----------------------------------------------------------------------
----------------------------------------------------------------------
----------------------------------------------------------------------
----------------------------------------------------------------------
----------------------------------------------------------------------
----------------------------------------------------------------------
----------------------------------------------------------------------
----------------------------------------------------------------------
----------------------------------------------------------------------
----------------------------------------------------------------------
----------------------------------------------------------------------
----------------------------------------------------------------------
----------------------------------------------------------------------
----------------------------------------------------------------------
----------------------------------------------------------------------
----------------------------------------------------------------------
----------------------------------------------------------------------
