GGGGGGGGGGGGGGGGGGGGGGGGGGGGGGGGGGGGGGGGGGGGGGGGGGG
G------------------------------------------------G
G------------------------------------------------G
G----------------------------------------------D-G
G-----------------------------------GGGGGGGGGGGGGG
G------------------------------------------------G
GM--------------------i------B------i------------G
GM---------------------GGGGGGGGGGGGG-------------G
GM------------GGGGGGG----------------------------G
GM---GGGGGGG-------------------------------------G
GM-----------------------------------------------G
GM-----------------------------------------------G
GM-----------------------------------------------G
GM----------B------------i-----------------------G
GGGGGGGGGGGGGGGGGGGGGGGGG------------------------G
G------------------------------------------------G
G--------------------------GGGGGGGGG-------------G
G------------------------------------------------G
G-------------------^^---------------------------G
G----------------GGGGGGGGG-----------------------G
G------------GM----------------------------------G
G------^^----GM----------------------------------G
G------GG----GM----------------------------------G
G-----GGG---^GM----------------------------------G
G-S--GGGG---^GM----------------------------------G
G---GGK------------------------------------------G
GGGGGGGGGGGGGGGGGGGGGGGGGGGGGGGGGGGGGGGGGGGGGGGGGGG
GGGGGGGGGGGGGGGGGGGGGGGGGGGGGGGGGGGGGGGGGGGGGGGGGGG
GGGGGGGGGGGGGGGGGGGGGGGGGGGGGGGGGGGGGGGGGGGGGGGGGGG