GGGGGGGGGGGGGGGGGGGGGGGGGGGGGGGGGGGGGGGGGGGGGGGGGGG
G------------------------------------------------G
G------------------------------------------------G
G------------------------------------------------G
G------------------------------------------------G
G------------------------------------------------G
G------------------------------------------------G
G-----------------MG-----------------------------G
G------GM----------G-----------------------------G
G------GM----------G-----------------------------G
G------GM----------G-----------------------------G
G------GM----------G-----------------------------G
G------GM----------GM----------------------------G
G------GM----------------------------------------G
G------GM----------------------------------------G
G------GM----------------------------------------G
G------GM----------------------------------------G
G------GM-------------MGM------------------------G
G------G--------------MGM------------------------G
G---------------------MGM----G-------------------G
G---------------------MGM---MGM------------------G
G---------------------MGM---MGM------------------G
G---------------------MGM---MGM------------------G
G---------------------------MGM------------------G
G-S-------------------------MGM------------------G
G--------^---K--------------MGM----------------D-G
GGGGGGGGGGGGGGGGGGGGGGGGGGGGGG------GGGGGGGGGGGG
GGGGGGGGGGGGGGGGGGGGGGGGGGGGGGGGGGGGGGGGGGGGGGGGGGG
GGGGGGGGGGGGGGGGGGGGGGGGGGGGGGGGGGGGGGGGGGGGGGGGGGG