GGGGGGGGGGGGGGGGGGGGGGGGGGGGGGGGGGGGGGGGGGGGGGGGGGG
G------------------------------------------------G
G------------------------------------------------G
G-------------------------------------^^-------D-G
G-----------------------------------GGGGGGGGGGGGGG
GB---------------------------------------------B-G
GM--------------------iB-----------Bi-----------cG
GM-----------i---B---i-GGGGGGGGGGGGG-------------G
GM--i---B---i-GGGGGGG----------------------------G
GM---GGGGGGG-------------------------------------G
GM-----------------------------------------------G
GM----------------------BB-----------------------G
GM-----------------------------------------------G
GMB---------^^^^--------Bi-----------------------G
GGGGGGGGGGGGGGGGGGGGGGGGG------------------------G
G-------------------------i---B-----i------------G
G--------------------------GGGGGGGGG-------------G
G-----------------------------------------------cG
G-------------------^^---------------------------G
G----------------GGGGGGGGG-----------------------G
G------------GM----------------------------------G
G------^^----GM------------------------^---------G
G------GG----GM-----------------------MGM--------G
G-----GGG---^GM-----------------------MGM--------G
G-S--GGGG---^GM-----------------------MGM--------G
G---GGK-------------------------------MGM------K-G
GGGGGGGGGGGGGGGGGGGGGGGGGGGGGGGGGGGGGGGGGGGGGGGGGGG
GGGGGGGGGGGGGGGGGGGGGGGGGGGGGGGGGGGGGGGGGGGGGGGGGGG
GGGGGGGGGGGGGGGGGGGGGGGGGGGGGGGGGGGGGGGGGGGGGGGGGGG