GGGGGGGGGGGGGGGGGGGGGGGGGGGGGGGGGGGGGGGGGGGGGGGGGG--------------------
G------------------------------------------------G--------------------
G------------------------------------------------G--------------------
G-------------------------------------^^-------D-G--------------------
G-----------------------------------GGGGGGGGGGGGGG--------------------
GB---------------------------------------------B-G--------------------
GM--------------------iB-----------Bi-----------cG--------------------
GM-----------i---B---i-GGGGGGGGGGGGG-------------G--------------------
GM--i---B---i-GGGGGGG----------------------------G--------------------
GM---GGGGGGG-------------------------------------G--------------------
GM----------------------------------------------cG--------------------
GM----------------------BB-----------------------G--------------------
GM-----------------------------------------------G--------------------
GMB---------^^^^--------Bi-----------------------G--------------------
GGGGGGGGGGGGGGGGGGGGGGGGG------------------------G--------------------
G-------------------------i---------BB------GM---G--------------------
G--------------------------GGGGGGGGGGGGGGGGGGM---G--------------------
G-------------------------------------------GM---G--------------------
G-------------------^^----------------------GM---G--------------------
G----------------GGGGGGGGG-------------^----GM---G--------------------
G------------GM-------c---------------MGM---GM---G--------------------
G------^^----GM-----------------------MGM---GM---G--------------------
G------GG----GM-----------------------MGM---GM---G--------------------
G-----GGG---^GM-----------------------MGM---GM---G--------------------
G-S--GGGG---^GM-----------------------MGM--------G--------------------
G---GGK-------------------------------MGM------K-G--------------------
GGGGGGGGGGGGGGGGGGGGGGGGGGGGGGGGGGGGGGGGGGGGGGGGGGG-------------------
GGGGGGGGGGGGGGGGGGGGGGGGGGGGGGGGGGGGGGGGGGGGGGGGGGG-------------------
GGGGGGGGGGGGGGGGGGGGGGGGGGGGGGGGGGGGGGGGGGGGGGGGGGG-------------------
----------------------------------------------------------------------
----------------------------------------------------------------------
----------------------------------------------------------------------
----------------------------------------------------------------------
----------------------------------------------------------------------
----------------------------------------------------------------------
----------------------------------------------------------------------
----------------------------------------------------------------------
----------------------------------------------------------------------
----------------------------------------------------------------------
----------------------------------------------------------------------
----------------------------------------------------------------------
----------------------------------------------------------------------
----------------------------------------------------------------------
----------------------------------------------------------------------
----------------------------------------------------------------------
----------------------------------------------------------------------
----------------------------------------------------------------------
----------------------------------------------------------------------
----------------------------------------------------------------------
----------------------------------------------------------------------
----------------------------------------------------------------------
----------------------------------------------------------------------
----------------------------------------------------------------------
----------------------------------------------------------------------
----------------------------------------------------------------------
----------------------------------------------------------------------
----------------------------------------------------------------------
----------------------------------------------------------------------
----------------------------------------------------------------------
----------------------------------------------------------------------
----------------------------------------------------------------------
----------------------------------------------------------------------
----------------------------------------------------------------------
----------------------------------------------------------------------
----------------------------------------------------------------------
----------------------------------------------------------------------
----------------------------------------------------------------------
----------------------------------------------------------------------
----------------------------------------------------------------------
----------------------------------------------------------------------
