GGGGGGGGGGGGGGGGGGGGGGGGGGGGGGGGGGGGGGGGGGGGGGGGGGG-------------------
G------------------------------------------------G--------------------
G------------------------------------------------G--------------------
G-------------------------------------^^-------D-G--------------------
G-----------------------------------GGGGGGGGGGGGGG--------------------
GB---------------------------------------------B-G--------------------
GM--------------------iB-----------Bi-----------cG--------------------
GM-----------i---B---i-GGGGGGGGGGGGG-------------G--------------------
GM--i---B---i-GGGGGGG----------------------------G--------------------
GM---GGGGGGG-------------------------------------G--------------------
GM-----------------------------------------------G--------------------
GM----------------------BB-----------------------G--------------------
GM-----------------------------------------------G--------------------
GMB---------^^^^--------Bi-----------------------G--------------------
GGGGGGGGGGGGGGGGGGGGGGGGG------------------------G--------------------
G-------------------------i---B-----i------------G--------------------
G--------------------------GGGGGGGGG-------------G--------------------
G-----------------------------------------------cG--------------------
G-------------------^^---------------------------G--------------------
G-------------K--GGGGGGGGG-----------------------G--------------------
G------------GMB--------------------------------BG--------------------
G------^^----GM-----------------------^^^--------G--------------------
G------GG----GM----------------------MGGGM-------G--------------------
G-----GGG^--^GM----------------------MGGGM-------G--------------------
GS---GGGG^--^GM-----------BB---------MGGGM-------G--------------------
G---GGK---------B--------^^^^--------MGGGM-^^--K-G--------------------
GGGGGGGGGGGGGGGGGGGGGGGGGGGGGGGGGGGGGGGGGGGGGGGGGGG-------------------
GGGGGGGGGGGGGGGGGGGGGGGGGGGGGGGGGGGGGGGGGGGGGGGGGGG-------------------
GGGGGGGGGGGGGGGGGGGGGGGGGGGGGGGGGGGGGGGGGGGGGGGGGGG-------------------
----------------------------------------------------------------------
----------------------------------------------------------------------
----------------------------------------------------------------------
----------------------------------------------------------------------
----------------------------------------------------------------------
----------------------------------------------------------------------
----------------------------------------------------------------------
----------------------------------------------------------------------
----------------------------------------------------------------------
----------------------------------------------------------------------
----------------------------------------------------------------------
----------------------------------------------------------------------
----------------------------------------------------------------------
----------------------------------------------------------------------
----------------------------------------------------------------------
----------------------------------------------------------------------
----------------------------------------------------------------------
----------------------------------------------------------------------
----------------------------------------------------------------------
----------------------------------------------------------------------
----------------------------------------------------------------------
----------------------------------------------------------------------
----------------------------------------------------------------------
----------------------------------------------------------------------
----------------------------------------------------------------------
----------------------------------------------------------------------
----------------------------------------------------------------------
----------------------------------------------------------------------
----------------------------------------------------------------------
----------------------------------------------------------------------
----------------------------------------------------------------------
----------------------------------------------------------------------
----------------------------------------------------------------------
----------------------------------------------------------------------
----------------------------------------------------------------------
----------------------------------------------------------------------
----------------------------------------------------------------------
----------------------------------------------------------------------
----------------------------------------------------------------------
----------------------------------------------------------------------
----------------------------------------------------------------------
