-------------GGG------------------------
-------------GGG------------------------
-------------GGG------------------------
-------------GGG------------------------
-------------GGG------------------------
-------------GGG------------------------
-------------GGG------------------------
-------------GGG------------------------
-------------GGG------------------------
-------------GGG------------------------
-------------GGG------------------------
-------------GGG------------------------
-------------GGG------------------------
-------------GGG------------------------
-------------GGG------------------------
-------------GGG------------------------
-------------GGG------------------------
-------------GGG------------------------
-------------GGG------------------------
-------------GGG----GGG-----------------
-------------GGG----GGG-----------------
-------------GGG----GGG-----------------
-------------GGG----GGG-----------------
--------------------GGG-----------------
--------------------GGG-----------------
---s----------------GGG-----------------
--------------------GGG---------------D-
GGGGGGGGGGGGGGGGGGGGGGGGGGGGGGGGGGGGGGGGG
GGGGGGGGGGGGGGGGGGGGGGGGGGGGGGGGGGGGGGGGG
GGGGGGGGGGGGGGGGGGGGGGGGGGGGGGGGGGGGGGGGG