-------------GGG------------------------
-------------GGG------------------------
-------------GGG------------------------
-------------GGG------------------------
-------------GGG------------------------
-------------GGG------------------------
-------------GGG------------------------
-------------GGG------------------------
-------------GGG------------------------
-------------GGG------------------------
-------------GGG------------------------
-------------GGG------------------------
-------------GGG------------------------
-------------GGG------------------------
-------------GGG------------------------
-------------GGG------------------------
-------------GGG------------------------
-------------GGG------------------------
-------------GGG------------------------
-------------GGG----GGG-----------------
-------------GGG----GGG-----------------
-------------GGG----GGG-----------------
-------------GGG----GGG-----------------
--------------------GGG-----------------
--------------------GGG-----------------
--------------------GGG-----------------
--------------------GGG---------------D-
GGGGGGGGGGGGGGGGGGGGGGGGGGGGGGGGGGGAGGGGG
GGGGGGGGGGGGGGGGGGGGGGGGGGGGGGGGGGGGGGGGG
GGGGGGGGGGGGGGGGGGGGGGGGGGGGGGGGGGGGGGGGG