GGGGGGGGGGGGGGGGGGGGGGGGGGGGGGGGGGGGGGGGGGGGGGGGGGG
G------------------------------------------------G
GK----------------------------------------------KG
GGGG------------------------------------------GGGG
G----------------------------------------GGG-----G
G------------------------------------------------G
GGGGGGGGGGGGGGGGGGGGGGGGGGGGGGGGGGGGGGG----------G
G------------------------------------------------G
G-----------------------------------------------lG
G------------------------------------------------G
G--------GGGGGGGGGGGGGGGGGGGGGGGGGGGGGGGGGGGGGGGGGG
G------------------------------------------------G
G-----------------------------------------------lG
G------------------------------------S-----------G
GGGGGGGGGGGGGGGGGGGGGGGGGGGGGGGGGGGGGGG----------G
G------------------------------------------------G
G------------------------------------------------G
G------------------------------------------------G
G--------GGGGGGGGGGGGGGGGGGGGGGGGGGGGGGGGGGGGGGGGG
G------------------------------------------------G
G-----------------------------------------------lG
G------------------------------------------------G
GGGGGGGGGGGGGGGGGGGGGGGGGGGGGGGGGGGGGGG----------G
G------------------------------------------------G
G-----------------------------------------------lG
G-D----------------------------------------------G
GGGGGGGGGGGGGGGGGGGGGGGGGGGGGGGGGGGGGGGGGGGGGGGGGGG
GGGGGGGGGGGGGGGGGGGGGGGGGGGGGGGGGGGGGGGGGGGGGGGGGGG
GGGGGGGGGGGGGGGGGGGGGGGGGGGGGGGGGGGGGGGGGGGGGGGGGGG