GGGGGGGGGGGGGGGGGGGGGGGGGGGGGGGGGGGGGGGGGGGGGGGGGGG-------------------
G-----------------------e------------------------G--------------------
GK-^--------------------------------------------KG--------------------
GGGG---------------------------------------^--GGGG--------------------
G----------------------------------------GGG-----G--------------------
Gc-----------------------------------------------G--------------------
GGGGGGGGGGGGGGGGGGGGGGGGGGGGGGGGGGGGGGG----------G--------------------
G-----------------------------------------------cG--------------------
G-----------------------------------------------lG--------------------
Ge-----------------------------------------------G--------------------
Ge-------GGGGGGGGGGGGGGGGGGGGGGGGGGGGGGGGGGGGGGGGGG-------------------
Ge-----------------------------------------------G--------------------
G-----------------------------------------------lG--------------------
G------------------------------------S-----------G--------------------
GGGGGGGGGGGGGGGGGGGGGGGGGGGGGGGGGGGGGGG----------G--------------------
GK-------------------^^--^^----------------------G--------------------
G------------------------------------------------G--------------------
GG^--------------------^^--^^--------------------G--------------------
Ge-----^GGGGGGGGGGGGGGGGGGGGGGGGGGGGGGGGGGGGGGGGGG--------------------
G-------^----------------------------------------G--------------------
G-----------------------------------------------lG--------------------
G----------^^^^------------B----------^----------G--------------------
GGGGGGGGGGGGGGGGGGGGGGGGGGGGGGGGGGGGGGG----------G--------------------
G------------------------------------------------G--------------------
G-----------------------------------------------lG--------------------
G-D----------------------------------------------G--------------------
GGGGGGGGGGGGGGGGGGGLLLLGGGGGGGGGGGGGGGGGGGGGGGGGGGG-------------------
GGGGGGGGGGGGGGGGGGGGGGGGGGGGGGGGGGGGGGGGGGGGGGGGGGG-------------------
GGGGGGGGGGGGGGGGGGGGGGGGGGGGGGGGGGGGGGGGGGGGGGGGGGG-------------------
----------------------------------------------------------------------
----------------------------------------------------------------------
----------------------------------------------------------------------
----------------------------------------------------------------------
----------------------------------------------------------------------
----------------------------------------------------------------------
----------------------------------------------------------------------
----------------------------------------------------------------------
----------------------------------------------------------------------
----------------------------------------------------------------------
----------------------------------------------------------------------
----------------------------------------------------------------------
----------------------------------------------------------------------
----------------------------------------------------------------------
----------------------------------------------------------------------
----------------------------------------------------------------------
----------------------------------------------------------------------
----------------------------------------------------------------------
----------------------------------------------------------------------
----------------------------------------------------------------------
----------------------------------------------------------------------
----------------------------------------------------------------------
----------------------------------------------------------------------
----------------------------------------------------------------------
----------------------------------------------------------------------
----------------------------------------------------------------------
----------------------------------------------------------------------
----------------------------------------------------------------------
----------------------------------------------------------------------
----------------------------------------------------------------------
----------------------------------------------------------------------
----------------------------------------------------------------------
----------------------------------------------------------------------
----------------------------------------------------------------------
----------------------------------------------------------------------
----------------------------------------------------------------------
----------------------------------------------------------------------
----------------------------------------------------------------------
----------------------------------------------------------------------
----------------------------------------------------------------------
----------------------------------------------------------------------
