GGGGGGGGGGGGGGGGGGGGGGGGGGGGGGGGGGGGGGGGGGGGGGGGGGG-------------------
G-----------------------e------e-----------------G--------------------
GK-^--------------------------------------------KG--------------------
GGGG---------------------------------------^--GGGG--------------------
G----------------------------------------GGG-----G--------------------
Gc-------B-------------B--------------Bi---------G--------------------
GGGGGGGGGGGGGGGGGGGGGGGGGGGGGGGGGGGGGGG----------G--------------------
G-----------------------------------------------cG--------------------
G-----------------------------------------------lG--------------------
Ge--------------------------G^B------------------G--------------------
Ge-------GGGGGGGGGGGGGGGGGGGGGGGGGGGGGGGGGGGGGGGGGG-------------------
Ge-----------------------------------------------G--------------------
G-----------------------------------------------lG--------------------
GB-----------------------------------S-----------G--------------------
GGGGGGGGGGGGGGGGGGGGGGGGGGGGGGGGGGGGGGG----------G--------------------
GK---------------^^--^^--^^----------------------G--------------------
G------------------------------------------------G--------------------
GG^------------^^--^^--^^--^^--------------------G--------------------
Ge-----^GGGGGGGGGGGGGGGGGGGGGGGGGGGGGGGGGGGGGGGGGG--------------------
G-------^------------------------------l---------G--------------------
G-----------------------------------------------lG--------------------
G----------^^^^------------B----------^----------G--------------------
GGGGGGGGGGGGGGGGGGGGGGGGGGGGGGGGGGGGGGG----------G--------------------
G------------------------------------------------G--------------------
G-----------------------------------------------lG--------------------
G-D-----------^^^--------^^^---------------------G--------------------
GGGGGGGGGGGGGGGGGGGLLLLGGGGGGGGGGGGGGGGLLLGGGGGGGGG-------------------
GGGGGGGGGGGGGGGGGGGGGGGGGGGGGGGGGGGGGGGGGGGGGGGGGGG-------------------
GGGGGGGGGGGGGGGGGGGGGGGGGGGGGGGGGGGGGGGGGGGGGGGGGGG-------------------
----------------------------------------------------------------------
----------------------------------------------------------------------
----------------------------------------------------------------------
----------------------------------------------------------------------
----------------------------------------------------------------------
----------------------------------------------------------------------
----------------------------------------------------------------------
----------------------------------------------------------------------
----------------------------------------------------------------------
----------------------------------------------------------------------
----------------------------------------------------------------------
----------------------------------------------------------------------
----------------------------------------------------------------------
----------------------------------------------------------------------
----------------------------------------------------------------------
----------------------------------------------------------------------
----------------------------------------------------------------------
----------------------------------------------------------------------
----------------------------------------------------------------------
----------------------------------------------------------------------
----------------------------------------------------------------------
----------------------------------------------------------------------
----------------------------------------------------------------------
----------------------------------------------------------------------
----------------------------------------------------------------------
----------------------------------------------------------------------
----------------------------------------------------------------------
----------------------------------------------------------------------
----------------------------------------------------------------------
----------------------------------------------------------------------
----------------------------------------------------------------------
----------------------------------------------------------------------
----------------------------------------------------------------------
----------------------------------------------------------------------
----------------------------------------------------------------------
----------------------------------------------------------------------
----------------------------------------------------------------------
----------------------------------------------------------------------
----------------------------------------------------------------------
----------------------------------------------------------------------
----------------------------------------------------------------------
