GGGGGGGGGGGGGGGGGGGGGGGGGGGGGGGGGGGGGGGGGGGGGGGGGGG-------------------
G------------------c------------------------ll---G--------------------
GK----------------------------------------------KG--------------------
GGGG------------------------------------------GGGG--------------------
G----------------------------------------GGG-----G--------------------
G----------------------------------------GKGM----G--------------------
GGGGGGGLLLLLGGGGGGGGGGGGGGGGGGGGGGGGGGG--GMGM----G--------------------
GGGGGGGGGGGGGGGG-------------------------GMG-----G--------------------
GK---------------------------------------GMG-----G--------------------
GGGG^------------------------------------GMG-----G--------------------
G------------------------GGGGGGGGGGGGGGGGG---MGGGGG-------------------
G-----------------------GG---------------G----G--G--------------------
G----------------------GG----------------G^^^^G--G--------------------
G---G-----------------GG--S--------------GGGGGG--G--------------------
G----------GGGGGGGGGGGGGGGGGGGGGGGGGGG----GG-----G--------------------
G---------GG---e--------------------------GG-----G--------------------
G--------GG-------------------------------GG-----G--------------------
G-------GG--------------------------------GG-----G--------------------
G------GG----------------GGGGGGGGGGGGGGGM--------G--------------------
G-----------------------GG-------------GM-------KG--------------------
G----------------------GG--------------GM----GGGGG--------------------
G---------------------GG-K--B----------G^^^^^GG--G--------------------
GGGGGGGGGG----GGGGGGGGGGGGGGGGGGGGGGG--GGGGGGGG--G--------------------
G--------GG--------------------------------------G--------------------
G---------GG-------------------------------------G--------------------
G----------GG----------------------------------D-G--------------------
GGGGGGGGGGGGGGGGGGGGGLLLLGGGGGGGGGGGGGGGGGGGGGGGGGG-------------------
GGGGGGGGGGGGGGGGGGGGGGGGGGGGGGGGGGGGGGGGGGGGGGGGGGG-------------------
GGGGGGGGGGGGGGGGGGGGGGGGGGGGGGGGGGGGGGGGGGGGGGGGGGG-------------------
----------------------------------------------------------------------
----------------------------------------------------------------------
----------------------------------------------------------------------
----------------------------------------------------------------------
----------------------------------------------------------------------
----------------------------------------------------------------------
----------------------------------------------------------------------
----------------------------------------------------------------------
----------------------------------------------------------------------
----------------------------------------------------------------------
----------------------------------------------------------------------
----------------------------------------------------------------------
----------------------------------------------------------------------
----------------------------------------------------------------------
----------------------------------------------------------------------
----------------------------------------------------------------------
----------------------------------------------------------------------
----------------------------------------------------------------------
----------------------------------------------------------------------
----------------------------------------------------------------------
----------------------------------------------------------------------
----------------------------------------------------------------------
----------------------------------------------------------------------
----------------------------------------------------------------------
----------------------------------------------------------------------
----------------------------------------------------------------------
----------------------------------------------------------------------
----------------------------------------------------------------------
----------------------------------------------------------------------
----------------------------------------------------------------------
----------------------------------------------------------------------
----------------------------------------------------------------------
----------------------------------------------------------------------
----------------------------------------------------------------------
----------------------------------------------------------------------
----------------------------------------------------------------------
----------------------------------------------------------------------
----------------------------------------------------------------------
----------------------------------------------------------------------
----------------------------------------------------------------------
----------------------------------------------------------------------
