GGGGGGGGGGGGGGGGGGGGGGGGGGGGGGGGGGGGGGGGGGGGGGGGGGG-------------------
G------------------------------------------------G--------------------
GK----------------------------------------------KG--------------------
GGGG------------------------------------------GGGG--------------------
G----------------------------------------GGG-----G--------------------
G----------------------------------------GKGM----G--------------------
GGGGGGGGGGGGGGGGGGGGGGGGGGGGGGGGGGGGGGG--GMGM----G--------------------
G----------------------------------------GMG-----G--------------------
G----------------------------------------GMG-----G--------------------
G----------------------------------------GMG-----G--------------------
G--------GGGGGGGGGGGGGGGGGGGGGGGGGGGGGGGGG---MGGGGG-------------------
G----------------------------------------G----G--G--------------------
G----------------------------------------G^^^^G--G--------------------
G------------------------------------S---GGGGGG--G--------------------
GGGGGGGGGGGGGGGGGGGGGGGGGGGGGGGGGGGGGG----GG-----G--------------------
G-----------------------------------------GG-----G--------------------
G-----------------------------------------GG-----G--------------------
G-----------------------------------------GG-----G--------------------
G--------GGGGGGGGGGGGGGGGGGGGGGGGGGGGGGGM-GG-----G--------------------
G--------------------------------------GM-------KG--------------------
G--------------------------------------GM----GGGGG--------------------
G--------------------------------------G^^^^^GG--G--------------------
GGGGGGGGGGGGGGGGGGGGGGGGGGGGGGGGGGGGG--GGGGGGGG--G--------------------
G------------------------------------------------G--------------------
G------------------------------------------------G--------------------
G-D----------------------------------------------G--------------------
GGGGGGGGGGGGGGGGGGGGGGGGGGGGGGGGGGGGGGGGGGGGGGGGGGG-------------------
GGGGGGGGGGGGGGGGGGGGGGGGGGGGGGGGGGGGGGGGGGGGGGGGGGG-------------------
GGGGGGGGGGGGGGGGGGGGGGGGGGGGGGGGGGGGGGGGGGGGGGGGGGG-------------------
----------------------------------------------------------------------
----------------------------------------------------------------------
----------------------------------------------------------------------
----------------------------------------------------------------------
----------------------------------------------------------------------
----------------------------------------------------------------------
----------------------------------------------------------------------
----------------------------------------------------------------------
----------------------------------------------------------------------
----------------------------------------------------------------------
----------------------------------------------------------------------
----------------------------------------------------------------------
----------------------------------------------------------------------
----------------------------------------------------------------------
----------------------------------------------------------------------
----------------------------------------------------------------------
----------------------------------------------------------------------
----------------------------------------------------------------------
----------------------------------------------------------------------
----------------------------------------------------------------------
----------------------------------------------------------------------
----------------------------------------------------------------------
----------------------------------------------------------------------
----------------------------------------------------------------------
----------------------------------------------------------------------
----------------------------------------------------------------------
----------------------------------------------------------------------
----------------------------------------------------------------------
----------------------------------------------------------------------
----------------------------------------------------------------------
----------------------------------------------------------------------
----------------------------------------------------------------------
----------------------------------------------------------------------
----------------------------------------------------------------------
----------------------------------------------------------------------
----------------------------------------------------------------------
----------------------------------------------------------------------
----------------------------------------------------------------------
----------------------------------------------------------------------
----------------------------------------------------------------------
----------------------------------------------------------------------
