GGGGGGGGGGGGGGGGGGGGGGGGGGGGGGGGGGGGGGGGGGGGGGGGGGG-------------------
G------------------c------------------------ll---G--------------------
GK----------------------------------------------KG--------------------
GGGG------------------------------------------GGGG--------------------
G----------------------------------------GGG-----G--------------------
G----------------------------------------GKGM----G--------------------
GGGGGLLLLLGLLLLLGGGGGGGGGGGGGGGGGGGGGGG--GMGM----G--------------------
GGGGGGGGGGGGGGGGGe-----------------------GMG-----G--------------------
GK-----e---------------------------------GMG-----G--------------------
GGGG^------------------------------------GMG-----G--------------------
G------------------------GGGGGGGGGGGGGGGGG---MGGGGG-------------------
G-----------------------GG---------------G----GGGG--------------------
G----------------------GG----------------G^^^^GGGG--------------------
G--^G^--------^^^^^---GG--S--------------GGGGGGGGG--------------------
G---^------GGGGGGGGGGGGGGGGGGGGGGGGGGG----GG--e--G--------------------
G---------GG---e-----------^^--^^---------GG-----G--------------------
G--------GG-------------------------------GG-----G--------------------
G-------GG---------------^^--^^-----------GG-----G--------------------
G------GG----------------GGGGGGGGGGGGGGGM--------G--------------------
G-----------------------GG-------------GM-------KG--------------------
Gl---------------------GG--------------GM----GGGGG--------------------
Gl--------------------GG-K--B--------i-G^^^^^GG--G--------------------
GGGGGGGGGG----GGGGGGGGGGGGGGGGGGGGGGG--GGGGGGGG--G--------------------
GGGGGGGGGGG--------------------------------------G--------------------
GGGGGGGGGGGG-------------------------------------G--------------------
GGGGGGGGGGGGG^B-----^---i------B----------B----D-G--------------------
GGGGGGGGGGGGGGGGGGGGGLLLLGGGGGGGGGGGGGGGGGGGGGGGGGG-------------------
GGGGGGGGGGGGGGGGGGGGGGGGGGGGGGGGGGGGGGGGGGGGGGGGGGG-------------------
GGGGGGGGGGGGGGGGGGGGGGGGGGGGGGGGGGGGGGGGGGGGGGGGGGG-------------------
----------------------------------------------------------------------
----------------------------------------------------------------------
----------------------------------------------------------------------
----------------------------------------------------------------------
----------------------------------------------------------------------
----------------------------------------------------------------------
----------------------------------------------------------------------
----------------------------------------------------------------------
----------------------------------------------------------------------
----------------------------------------------------------------------
----------------------------------------------------------------------
----------------------------------------------------------------------
----------------------------------------------------------------------
----------------------------------------------------------------------
----------------------------------------------------------------------
----------------------------------------------------------------------
----------------------------------------------------------------------
----------------------------------------------------------------------
----------------------------------------------------------------------
----------------------------------------------------------------------
----------------------------------------------------------------------
----------------------------------------------------------------------
----------------------------------------------------------------------
----------------------------------------------------------------------
----------------------------------------------------------------------
----------------------------------------------------------------------
----------------------------------------------------------------------
----------------------------------------------------------------------
----------------------------------------------------------------------
----------------------------------------------------------------------
----------------------------------------------------------------------
----------------------------------------------------------------------
----------------------------------------------------------------------
----------------------------------------------------------------------
----------------------------------------------------------------------
----------------------------------------------------------------------
----------------------------------------------------------------------
----------------------------------------------------------------------
----------------------------------------------------------------------
----------------------------------------------------------------------
----------------------------------------------------------------------
