GGGGGGGGGGGGGGGGGGGGGGGGGGGGGGGGGGGGGGGGGGGGGGGGGGG-------------------
G------------------c---e--------------------ll---G--------------------
GK----------------------------------------------KG--------------------
GGGG^-------------------------------------^---GGGG--------------------
G----------------------------------------GGG-----G--------------------
G--------------i----------B------------i-GKGM----G--------------------
GGGGGLLLLLGLLLLLGGGGGGGGGGGGGGGGGGGGGGG--GMGM----G--------------------
GGGGGGGGGGGGGGGGGe-----------------------GMG-----G--------------------
GK-----e---------------------------------GMG-----G--------------------
G-----------------------i----------B-----GMG-----G--------------------
GGGG^--------------------GGGGGGGGGGGGGGGGG---MGGGGG-------------------
G-----------------------GG--------------G^----GGGG--------------------
G----------------------GG---------------G-l^^^GGGG--------------------
G-------------^^^^^---GG--S-------------GGGGGGGGGG--------------------
G--^G^------GGGGGGGGGGGGGGGGGGGGGGGGGG----GG--e--G--------------------
G---^----------e-----------^^--^^---------GG-----G--------------------
G-----------------------------------------GG-----G--------------------
G------------------------^^--^^-----------GG-----G--------------------
G--------GG--------------GGGGGGGGGGGGGGGM-GG-----G--------------------
G---------GG------------GG-------------GM-------KG--------------------
Gl---------GG----------GGl-------------GM----GGGGG--------------------
Gl----------GG--------GG-i--B---------KG^^^^^GG--G--------------------
GGGGGGGGGG---GGGGGGGGGGG--GGGGGGGGGGGGGGGGGGGGG--G--------------------
GGGGGGGGGGG-------------------------e------------G--------------------
GGGGGGGGGGGG-------------------------------------G--------------------
GGGGGGGGGGGGG^B-----^---i------B----------B----D-G--------------------
GGGGGGGGGGGGGGGGGGGGGLLLLGGGGGGGGGGGGGGGGGGGGGGGGGG-------------------
GGGGGGGGGGGGGGGGGGGGGGGGGGGGGGGGGGGGGGGGGGGGGGGGGGG-------------------
GGGGGGGGGGGGGGGGGGGGGGGGGGGGGGGGGGGGGGGGGGGGGGGGGGG-------------------
----------------------------------------------------------------------
----------------------------------------------------------------------
----------------------------------------------------------------------
----------------------------------------------------------------------
----------------------------------------------------------------------
----------------------------------------------------------------------
----------------------------------------------------------------------
----------------------------------------------------------------------
----------------------------------------------------------------------
----------------------------------------------------------------------
----------------------------------------------------------------------
----------------------------------------------------------------------
----------------------------------------------------------------------
----------------------------------------------------------------------
----------------------------------------------------------------------
----------------------------------------------------------------------
----------------------------------------------------------------------
----------------------------------------------------------------------
----------------------------------------------------------------------
----------------------------------------------------------------------
----------------------------------------------------------------------
----------------------------------------------------------------------
----------------------------------------------------------------------
----------------------------------------------------------------------
----------------------------------------------------------------------
----------------------------------------------------------------------
----------------------------------------------------------------------
----------------------------------------------------------------------
----------------------------------------------------------------------
----------------------------------------------------------------------
----------------------------------------------------------------------
----------------------------------------------------------------------
----------------------------------------------------------------------
----------------------------------------------------------------------
----------------------------------------------------------------------
----------------------------------------------------------------------
----------------------------------------------------------------------
----------------------------------------------------------------------
----------------------------------------------------------------------
----------------------------------------------------------------------
----------------------------------------------------------------------
