GGGGGGGGGGGGGGGGGGGGGGGGGGGGGGGGGGGGGGGGGGGGGGGGGGG-------------------
G------------------c---e--------------------ll---G--------------------
GK----------------------------------------------KG--------------------
GGGG^-------------------------------------^---GGGG--------------------
G----------------------------------------GGG-----G--------------------
G--------------i----------B-----^^^^-----GKGM----G--------------------
GGGGGLLLLLGLLLLLGGGGGGGGGGGGGGGGGGGGGGG--GMGM----G--------------------
GGGGGGGGGGGGGGGGGe-----------------------GMG-----G--------------------
G-----------G----------------------------GMG-----G--------------------
G----------KG-----------i----------B-----GMG-----G--------------------
G---GG---GGGG------------GGGGGGGGGGGGGGGGG---MGLLGG-------------------
G--------G--------------GG--------------G^----GGGG--------------------
G---------------------------------------G-l^^^GGGG--------------------
G----^^-----G--^^^^----------^^--^^----SGGGGGGGGGG--------------------
GGG-^GG^---GGGGGGGGGGGGGGGGGGGGGGGGGGGGGGGGG--e--G--------------------
G----^^-----G--------------^^--^^---------GG-----G--------------------
G-----------------------------------------GG-----G--------------------
G------------------------^^--^^-----------GG-----G--------------------
G--GGG---GGGG------------GGGGGGGGGGGGGGGM-GG-----G--------------------
G--------GGGG-----------GG-------------GM-------KG--------------------
G--------GGGGG---------GGl-------------GM----GGGGG--------------------
GG-------GGGGGGGLLLLGGGG-i--B---------KG^^^^^GG--G--------------------
GGG^^^---GGGGGGGGGGGGGGG--GGGGGGGGGGGGGGGGGGGGG--G--------------------
GGGGGGG--GG-------------------------e------------G--------------------
GGGGGGG------------------------------------------G--------------------
GGGGGGGG-----^B-----^---i------B----------B----D-G--------------------
GGGGGGGGGGGGGGGGGGGGGLLLLGGGGGGGGGGGGGGGGGGGGGGGGGG-------------------
GGGGGGGGGGGGGGGGGGGGGGGGGGGGGGGGGGGGGGGGGGGGGGGGGGG-------------------
GGGGGGGGGGGGGGGGGGGGGGGGGGGGGGGGGGGGGGGGGGGGGGGGGGG-------------------
----------------------------------------------------------------------
----------------------------------------------------------------------
----------------------------------------------------------------------
----------------------------------------------------------------------
----------------------------------------------------------------------
----------------------------------------------------------------------
----------------------------------------------------------------------
----------------------------------------------------------------------
----------------------------------------------------------------------
----------------------------------------------------------------------
----------------------------------------------------------------------
----------------------------------------------------------------------
----------------------------------------------------------------------
----------------------------------------------------------------------
----------------------------------------------------------------------
----------------------------------------------------------------------
----------------------------------------------------------------------
----------------------------------------------------------------------
----------------------------------------------------------------------
----------------------------------------------------------------------
----------------------------------------------------------------------
----------------------------------------------------------------------
----------------------------------------------------------------------
----------------------------------------------------------------------
----------------------------------------------------------------------
----------------------------------------------------------------------
----------------------------------------------------------------------
----------------------------------------------------------------------
----------------------------------------------------------------------
----------------------------------------------------------------------
----------------------------------------------------------------------
----------------------------------------------------------------------
----------------------------------------------------------------------
----------------------------------------------------------------------
----------------------------------------------------------------------
----------------------------------------------------------------------
----------------------------------------------------------------------
----------------------------------------------------------------------
----------------------------------------------------------------------
----------------------------------------------------------------------
----------------------------------------------------------------------
