GGGGGGGGGGGGGGGGGGGGGGGGGGGGGGGGGGGGGGGGGGGGGGGGGGG-------------------
G---------l--------c---e--------------------ll---G--------------------
GK----------------------------------------------KG--------------------
GGGG^-------------------------------------^---GGGG--------------------
G----------------------------------------GGG-----G--------------------
G--------------i----------B-----^^^^-----GKGM----G--------------------
GGGGGLLLLLGLLLLLGGGGGGGGGGGGGGGGGGGGGGG--GMGM----G--------------------
GGGGGGGGGGGGGGGGGe-----------------------GMG-----G--------------------
G-----------G----------------------------GMG-----G--------------------
G----------KG---------i------------B-----GMG-----G--------------------
G--^GG^--GGGG----------GGGGGGGGGGGGGGGGGGG---MGLLGG-------------------
G---^^--^G------------GG----------------G^----GGGG--------------------
G--------^-----------GG-----------------G-l^^^GGGG--------------------
G----^^-----G--^^^^-GG-------^^--^^----SGGGGGGGGGG--------------------
GGG^^GG^--eGGGGGGGGGG----GGGGGGGGGGGGGGGGGGG--e--G--------------------
G----^^-----G--e-e------GG-^^--^^---------GG-----G--------------------
G----------------------GG-----------------GG-----G--------------------
G----^----------------GG-----^^-----------GG-----G--------------------
G-^GGG^--GG----------GGG----GGGGGGGGGGGGM-GG-----G--------------------
G--^^^---GGG--------GGGG--GGG----------GM------D-G--------------------
G--------GGGG------GGGGGl--------------GM----GGGGG--------------------
GG-------GGGGGLLLLGGGGGG-i--B---------KG^^^^^GGGGG--------------------
GGG^^^---GGGGGGGGGGGGGGG--GGGGGGGGGGGGGGGGGGGGGGGG--------------------
GGGGGGG-----------------------------e------------G--------------------
GGGGGGG------------------------------------------G--------------------
GGGGGGGG-----^B-----^---i------B----------B-----KG--------------------
GGGGGGGGGGGGGGGGGGGGGLLLLGGGGGGGGGGGGGGGGGGGGGGGGGG-------------------
GGGGGGGGGGGGGGGGGGGGGGGGGGGGGGGGGGGGGGGGGGGGGGGGGGG-------------------
GGGGGGGGGGGGGGGGGGGGGGGGGGGGGGGGGGGGGGGGGGGGGGGGGGG-------------------
----------------------------------------------------------------------
----------------------------------------------------------------------
----------------------------------------------------------------------
----------------------------------------------------------------------
----------------------------------------------------------------------
----------------------------------------------------------------------
----------------------------------------------------------------------
----------------------------------------------------------------------
----------------------------------------------------------------------
----------------------------------------------------------------------
----------------------------------------------------------------------
----------------------------------------------------------------------
----------------------------------------------------------------------
----------------------------------------------------------------------
----------------------------------------------------------------------
----------------------------------------------------------------------
----------------------------------------------------------------------
----------------------------------------------------------------------
----------------------------------------------------------------------
----------------------------------------------------------------------
----------------------------------------------------------------------
----------------------------------------------------------------------
----------------------------------------------------------------------
----------------------------------------------------------------------
----------------------------------------------------------------------
----------------------------------------------------------------------
----------------------------------------------------------------------
----------------------------------------------------------------------
----------------------------------------------------------------------
----------------------------------------------------------------------
----------------------------------------------------------------------
----------------------------------------------------------------------
----------------------------------------------------------------------
----------------------------------------------------------------------
----------------------------------------------------------------------
----------------------------------------------------------------------
----------------------------------------------------------------------
----------------------------------------------------------------------
----------------------------------------------------------------------
----------------------------------------------------------------------
----------------------------------------------------------------------
