GGGGGGGGGGGGGGGGGGGGGGGGGGGGGGGGGGGGGGGGGGGGGGGGGG--------------------
G-----------------------------------------------eG--------------------
G-S---------------------------------------------lG--------------------
G----------------------^^^-----------------------G--------------------
GGGGGGGGGGGGGGGGGGGGGGGGGGGGGGGGGGGGGGGGGGGGG----G--------------------
G----------------------------c--------------G----G--------------------
G------------------------------------------eG----G--------------------
G------------------------------------------lG----G--------------------
GM---G--------------------------------------G----G--------------------
GM---G--------------------------------------G----G--------------------
GM---G--------------------------------------G----G--------------------
GM---G------------------------------G-------GK---G--------------------
GM--^G-----------G-----G--------------------G----G--------------------
G---^G--------------------------------------G----G--------------------
G---MG------------------------G-------------G----G--------------------
G---MG------G-------------------------------G----G--------------------
G---MG--------------------------------------G----G--------------------
G---^G-------------------------------------DG----G--------------------
G---^G------------------------------------GGG----G--------------------
G---MG------------------------------------GGG----G--------------------
G---MG------------------------------------GGG----G--------------------
G---MG^^^^^^^^^^^^^^^^^^^^^^^^^^^^^^^^^^^^GGG----G--------------------
G---MGGGGGGGGGGGGGGGGGGGGGGGGGGGGGGGGGGGGGGGG----G--------------------
G------------------------------------------------G--------------------
G-----------------------------------------------lG--------------------
G--------^^^-----------^^^-----------^^^-----l---G--------------------
GGGGGGGGGGGGGGGGGGGGGGGGGGGGGGGGGGGGGGGGGGGGGGGGGG--------------------
GGGGGGGGGGGGGGGGGGGGGGGGGGGGGGGGGGGGGGGGGGGGGGGGGG--------------------
GGGGGGGGGGGGGGGGGGGGGGGGGGGGGGGGGGGGGGGGGGGGGGGGGG--------------------
----------------------------------------------------------------------
----------------------------------------------------------------------
----------------------------------------------------------------------
----------------------------------------------------------------------
----------------------------------------------------------------------
----------------------------------------------------------------------
----------------------------------------------------------------------
----------------------------------------------------------------------
----------------------------------------------------------------------
----------------------------------------------------------------------
----------------------------------------------------------------------
----------------------------------------------------------------------
----------------------------------------------------------------------
----------------------------------------------------------------------
----------------------------------------------------------------------
----------------------------------------------------------------------
----------------------------------------------------------------------
----------------------------------------------------------------------
----------------------------------------------------------------------
----------------------------------------------------------------------
----------------------------------------------------------------------
----------------------------------------------------------------------
----------------------------------------------------------------------
----------------------------------------------------------------------
----------------------------------------------------------------------
----------------------------------------------------------------------
----------------------------------------------------------------------
----------------------------------------------------------------------
----------------------------------------------------------------------
----------------------------------------------------------------------
----------------------------------------------------------------------
----------------------------------------------------------------------
----------------------------------------------------------------------
----------------------------------------------------------------------
----------------------------------------------------------------------
----------------------------------------------------------------------
----------------------------------------------------------------------
----------------------------------------------------------------------
----------------------------------------------------------------------
----------------------------------------------------------------------
----------------------------------------------------------------------
