GGGGGGGGGGGGGGGGGGGGGGGGGGGGGGGGGGGGGGGGGGGGGGGGGG--------------------
G-----------------------------------------------eG--------------------
G-S---------------------------------------------lG--------------------
G----------------------^^^^-----------------Bi---G--------------------
GGGGGGGGGGGGGGGGGGGGGGGGGGGGGGGGGGGGGGGGGGGGG----G--------------------
G----------------------------c--------------G----G--------------------
GK^----------------------------------------eG----G--------------------
GGG----------------------------------------lG----G--------------------
GM--MG--------------------------------------G----G--------------------
GM--MG--------------------------------------G----G--------------------
GM---G--------------------------------------G----G--------------------
GM---G----------^---------------------------GK---G--------------------
GM--^G--G^--N--^G^N----^G-----------G-------G----G--------------------
G---^G---------------------K----------------G----G--------------------
G---MG--------------------------------------G----G--------------------
G---MG-------------------------G------------G----G--------------------
G---MG--------------------------------------G----G--------------------
G---^G-------------------------------------DG----G--------------------
G---^G------------------------------------GGG----G--------------------
G---MG------------------------------------GGG----G--------------------
G---MG------------------------------------GGG----G--------------------
G---MG^^^^^^^^^^^^^^^^^^^^^^^^^^^^^^^^^^^^GGG----G--------------------
G---MGGGGGGGGGGGGGGGGGGGGGGGGGGGGGGGGGGGGGGGG----G--------------------
G------------------------------------------------G--------------------
G-----------------------------------------------lG--------------------
G----------------------^^^^------------------l---G--------------------
GGGGGGGGGGGGGGGGGGGGGGGGGGGGGGGGGGGGGGGGGGGGGGGGGG--------------------
GGGGGGGGGGGGGGGGGGGGGGGGGGGGGGGGGGGGGGGGGGGGGGGGGG--------------------
GGGGGGGGGGGGGGGGGGGGGGGGGGGGGGGGGGGGGGGGGGGGGGGGGG--------------------
----------------------------------------------------------------------
----------------------------------------------------------------------
----------------------------------------------------------------------
----------------------------------------------------------------------
----------------------------------------------------------------------
----------------------------------------------------------------------
----------------------------------------------------------------------
----------------------------------------------------------------------
----------------------------------------------------------------------
----------------------------------------------------------------------
----------------------------------------------------------------------
----------------------------------------------------------------------
----------------------------------------------------------------------
----------------------------------------------------------------------
----------------------------------------------------------------------
----------------------------------------------------------------------
----------------------------------------------------------------------
----------------------------------------------------------------------
----------------------------------------------------------------------
----------------------------------------------------------------------
----------------------------------------------------------------------
----------------------------------------------------------------------
----------------------------------------------------------------------
----------------------------------------------------------------------
----------------------------------------------------------------------
----------------------------------------------------------------------
----------------------------------------------------------------------
----------------------------------------------------------------------
----------------------------------------------------------------------
----------------------------------------------------------------------
----------------------------------------------------------------------
----------------------------------------------------------------------
----------------------------------------------------------------------
----------------------------------------------------------------------
----------------------------------------------------------------------
----------------------------------------------------------------------
----------------------------------------------------------------------
----------------------------------------------------------------------
----------------------------------------------------------------------
----------------------------------------------------------------------
----------------------------------------------------------------------
