GGGGGGGGGGGGGGGGGGGGGGGGGGGGGGGGGGGGGGGGGGGGGGGGGG--------------------
G-----------------------------------------------eG--------------------
G-S---------------------------------------------lG--------------------
G----------------------^^^-----------------------G--------------------
GGGGGGGGGGGGGGGGGGGGGGGGGGGGGGGGGGGGGGGGGGGGG----G--------------------
G-------------------------------------------G----G--------------------
GK-----------------------------------------lG----G--------------------
GGG-----------------------------------------G----G--------------------
GM---GGGGGGGGGGGGGGGGGGGGGGGGGGGGGGGGGGG----G----G--------------------
GM---G---------------------------------G----G----G--------------------
GM---G---------------------------------G----G----G--------------------
GM---G---------------------------------G----GK---G--------------------
GM--^GM--------------------------------G----G----G--------------------
G---^GM--------------------------------G----G----G--------------------
G---MGM--------------------------------G----G----G--------------------
G---MG---------------------------------G----G----G--------------------
G---MG---------------------------------G----G----G--------------------
G---^G---------------------------------G----G----G--------------------
G---^G---------------------------------G----G----G--------------------
G---MG--------------------------------------G----G--------------------
G---MG--------------------------------------GB---G--------------------
G---MG--------------------------------------G----G--------------------
G---MGGGGGGGGGGGGGGGGGGGGGGGGGGGGGGGGGGGGGGGG----G--------------------
G------------------------------------------------G--------------------
G-----------------------------------------------lG--------------------
G----------------------^^^-------------------l---G--------------------
GGGGGGGGGGGGGGGGGGGGGGGGGGGGGGGGGGGGGGGGGGGGGGGGGG--------------------
GGGGGGGGGGGGGGGGGGGGGGGGGGGGGGGGGGGGGGGGGGGGGGGGGG--------------------
GGGGGGGGGGGGGGGGGGGGGGGGGGGGGGGGGGGGGGGGGGGGGGGGGG--------------------
----------------------------------------------------------------------
----------------------------------------------------------------------
----------------------------------------------------------------------
----------------------------------------------------------------------
----------------------------------------------------------------------
----------------------------------------------------------------------
----------------------------------------------------------------------
----------------------------------------------------------------------
----------------------------------------------------------------------
----------------------------------------------------------------------
----------------------------------------------------------------------
----------------------------------------------------------------------
----------------------------------------------------------------------
----------------------------------------------------------------------
----------------------------------------------------------------------
----------------------------------------------------------------------
----------------------------------------------------------------------
----------------------------------------------------------------------
----------------------------------------------------------------------
----------------------------------------------------------------------
----------------------------------------------------------------------
----------------------------------------------------------------------
----------------------------------------------------------------------
----------------------------------------------------------------------
----------------------------------------------------------------------
----------------------------------------------------------------------
----------------------------------------------------------------------
----------------------------------------------------------------------
----------------------------------------------------------------------
----------------------------------------------------------------------
----------------------------------------------------------------------
----------------------------------------------------------------------
----------------------------------------------------------------------
----------------------------------------------------------------------
----------------------------------------------------------------------
----------------------------------------------------------------------
----------------------------------------------------------------------
----------------------------------------------------------------------
----------------------------------------------------------------------
----------------------------------------------------------------------
----------------------------------------------------------------------
