GGGGGGGGGGGGGGGGGGGGGGGGGGGGGGGGGGGGGGGGGGGGGGGGGG--------------------
G-----------------------------------------------eG--------------------
G-S---------------------------------------------lG--------------------
G----------------------^^^-----------------------G--------------------
GGGGGGGGGGGGGGGGGGGGGGGGGGGGGGGGGGGGGGGGGGGGG----G--------------------
G-------------------------------------------G----G--------------------
G------------------------------------------lG----G--------------------
G-------------------------------------------G----G--------------------
GM---GGGGGGGGGGGGGGGGGGGGGGGGGGGGGGGGGGG----G----G--------------------
GM---G---------------------------------G----G----G--------------------
GM---Gl--------------------------------G----G----G--------------------
GM---G-----------------^^^-------------G----GK---G--------------------
GM--^GM---GGGGGGGGGGGGGGGGGGGGGGGGG----G----G----G--------------------
G---^GM---Ge----------------------G----G----G----G--------------------
G---MGM---G----------------------DG----G----G----G--------------------
G---MG----G----GGGGGGGGGGGGGGGGGGGG----G----G----G--------------------
G---MG---MG----------------------------G----G----G--------------------
G---^G---MG----------------------------G----G----G--------------------
G---^G---MGGGGGGGGGGGGGGGGGGGGGGGGGGGGGG----G----G--------------------
G---MG--------------------------------------G----G--------------------
G---MG--------------------------------------GB---G--------------------
G---MG--------------------------------------G----G--------------------
G---MGGGGGGGGGGGGGGGGGGGGGGGGGGGGGGGGGGGGGGGG----G--------------------
G------------------------------------------------G--------------------
G-----------------------------------------------lG--------------------
Ge---------------------^^^-------------------l---G--------------------
GGGGGGGGGGGGGGGGGGGGGGGGGGGGGGGGGGGGGGGGGGGGGGGGGG--------------------
GGGGGGGGGGGGGGGGGGGGGGGGGGGGGGGGGGGGGGGGGGGGGGGGGG--------------------
GGGGGGGGGGGGGGGGGGGGGGGGGGGGGGGGGGGGGGGGGGGGGGGGGG--------------------
----------------------------------------------------------------------
----------------------------------------------------------------------
----------------------------------------------------------------------
----------------------------------------------------------------------
----------------------------------------------------------------------
----------------------------------------------------------------------
----------------------------------------------------------------------
----------------------------------------------------------------------
----------------------------------------------------------------------
----------------------------------------------------------------------
----------------------------------------------------------------------
----------------------------------------------------------------------
----------------------------------------------------------------------
----------------------------------------------------------------------
----------------------------------------------------------------------
----------------------------------------------------------------------
----------------------------------------------------------------------
----------------------------------------------------------------------
----------------------------------------------------------------------
----------------------------------------------------------------------
----------------------------------------------------------------------
----------------------------------------------------------------------
----------------------------------------------------------------------
----------------------------------------------------------------------
----------------------------------------------------------------------
----------------------------------------------------------------------
----------------------------------------------------------------------
----------------------------------------------------------------------
----------------------------------------------------------------------
----------------------------------------------------------------------
----------------------------------------------------------------------
----------------------------------------------------------------------
----------------------------------------------------------------------
----------------------------------------------------------------------
----------------------------------------------------------------------
----------------------------------------------------------------------
----------------------------------------------------------------------
----------------------------------------------------------------------
----------------------------------------------------------------------
----------------------------------------------------------------------
----------------------------------------------------------------------
